2021 super output area - lower layer,Total: All usual residents,Disabled under the Equality Act,Disabled under the Equality Act: Day-to-day activities limited a lot,Disabled under the Equality Act: Day-to-day activities limited a little,Not disabled under the Equality Act,Not disabled under the Equality Act: Has long term physical or mental health condition but day-to-day activities are not limited,Not disabled under the Equality Act: No long term physical or mental health conditions
E01004768 : Bolton 001A,"1,596",214,79,135,"1,382",137,"1,245"
E01004803 : Bolton 001B,"1,620",212,70,142,"1,408",128,"1,280"
E01004804 : Bolton 001C,"1,468",202,78,124,"1,266",133,"1,133"
E01004807 : Bolton 001D,"1,376",152,61,91,"1,224",94,"1,130"
E01004808 : Bolton 001E,"1,618",191,71,120,"1,427",127,"1,300"
E01004788 : Bolton 002A,"1,359",255,96,159,"1,104",103,"1,001"
E01004790 : Bolton 002B,"1,419",265,109,156,"1,154",120,"1,034"
E01004805 : Bolton 002C,"1,567",247,98,149,"1,320",133,"1,187"
E01004806 : Bolton 002D,"1,517",283,97,186,"1,234",109,"1,125"
E01004810 : Bolton 002E,"1,557",208,74,134,"1,349",134,"1,215"
E01004769 : Bolton 003A,"1,503",227,103,124,"1,276",121,"1,155"
E01004770 : Bolton 003B,"1,521",218,102,116,"1,303",96,"1,207"
E01004771 : Bolton 003C,"1,683",237,106,131,"1,446",120,"1,326"
E01004773 : Bolton 003D,"1,965",326,141,185,"1,639",146,"1,493"
E01004809 : Bolton 003E,"1,723",352,155,197,"1,371",136,"1,235"
E01004777 : Bolton 004A,"1,723",441,248,193,"1,282",103,"1,179"
E01004881 : Bolton 004B,"1,482",481,258,223,"1,001",94,907
E01004888 : Bolton 004C,"1,281",252,115,137,"1,029",111,918
E01004889 : Bolton 004D,"1,432",312,150,162,"1,120",82,"1,038"
E01004890 : Bolton 004E,"1,384",290,120,170,"1,094",98,996
E01004766 : Bolton 005A,"1,658",368,178,190,"1,290",90,"1,200"
E01004767 : Bolton 005B,"1,890",360,178,182,"1,530",82,"1,448"
E01004772 : Bolton 005C,"1,846",359,176,183,"1,487",95,"1,392"
E01004774 : Bolton 005D,"1,765",364,166,198,"1,401",137,"1,264"
E01004824 : Bolton 005E,"1,882",267,135,132,"1,615",41,"1,574"
E01004784 : Bolton 006A,"1,191",216,81,135,975,104,871
E01004785 : Bolton 006B,"1,522",327,164,163,"1,195",91,"1,104"
E01004786 : Bolton 006C,"1,450",268,126,142,"1,182",109,"1,073"
E01004789 : Bolton 006D,"1,452",240,87,153,"1,212",115,"1,097"
E01004791 : Bolton 006E,"1,323",221,94,127,"1,102",90,"1,012"
E01004792 : Bolton 006F,"1,413",225,98,127,"1,188",113,"1,075"
E01004779 : Bolton 007A,"1,636",303,133,170,"1,333",104,"1,229"
E01004781 : Bolton 007B,"2,132",294,126,168,"1,838",158,"1,680"
E01004882 : Bolton 007C,"1,350",267,121,146,"1,083",142,941
E01004883 : Bolton 007D,"1,760",249,116,133,"1,511",143,"1,368"
E01004884 : Bolton 007E,"1,475",227,71,156,"1,248",127,"1,121"
E01004864 : Bolton 008A,"1,462",256,117,139,"1,206",107,"1,099"
E01004867 : Bolton 008B,"1,551",245,118,127,"1,306",74,"1,232"
E01004921 : Bolton 008C,"1,633",274,119,155,"1,359",118,"1,241"
E01004924 : Bolton 008D,"1,573",205,81,124,"1,368",139,"1,229"
E01004925 : Bolton 008E,"1,589",252,110,142,"1,337",114,"1,223"
E01004778 : Bolton 009A,"1,190",228,109,119,962,79,883
E01004780 : Bolton 009B,"2,285",326,140,186,"1,959",168,"1,791"
E01004782 : Bolton 009C,"1,349",253,116,137,"1,096",95,"1,001"
E01004783 : Bolton 009D,"1,476",283,104,179,"1,193",113,"1,080"
E01004802 : Bolton 010A,"1,973",450,225,225,"1,523",104,"1,419"
E01004926 : Bolton 010B,"1,432",305,151,154,"1,127",79,"1,048"
E01004927 : Bolton 010C,"2,301",511,277,234,"1,790",122,"1,668"
E01004929 : Bolton 010D,"2,728",465,212,253,"2,263",169,"2,094"
E01004820 : Bolton 011A,"1,790",315,181,134,"1,475",46,"1,429"
E01004825 : Bolton 011B,"1,969",291,172,119,"1,678",65,"1,613"
E01004826 : Bolton 011C,"1,665",235,118,117,"1,430",49,"1,381"
E01004865 : Bolton 011D,"1,582",322,165,157,"1,260",87,"1,173"
E01004866 : Bolton 011E,"2,038",429,237,192,"1,609",71,"1,538"
E01004840 : Bolton 012A,"1,735",309,157,152,"1,426",107,"1,319"
E01004841 : Bolton 012B,"1,749",418,235,183,"1,331",77,"1,254"
E01004842 : Bolton 012C,"1,713",267,108,159,"1,446",128,"1,318"
E01004919 : Bolton 012D,"1,507",235,96,139,"1,272",125,"1,147"
E01004920 : Bolton 012E,"1,641",326,152,174,"1,315",132,"1,183"
E01004787 : Bolton 013A,"1,708",428,213,215,"1,280",92,"1,188"
E01004793 : Bolton 013B,"1,750",446,222,224,"1,304",84,"1,220"
E01004794 : Bolton 013C,"2,122",477,244,233,"1,645",101,"1,544"
E01004795 : Bolton 013D,"1,505",402,219,183,"1,103",76,"1,027"
E01004797 : Bolton 013E,"1,492",302,155,147,"1,190",82,"1,108"
E01004775 : Bolton 014A,"2,326",376,186,190,"1,950",160,"1,790"
E01004885 : Bolton 014B,"1,423",190,65,125,"1,233",107,"1,126"
E01004886 : Bolton 014C,"1,397",370,149,221,"1,027",99,928
E01004887 : Bolton 014D,"1,330",337,147,190,993,104,889
E01004868 : Bolton 015A,"2,163",278,132,146,"1,885",95,"1,790"
E01004869 : Bolton 015B,"2,188",363,169,194,"1,825",76,"1,749"
E01004870 : Bolton 015C,"2,015",413,195,218,"1,602",75,"1,527"
E01004871 : Bolton 015D,"1,814",211,111,100,"1,603",57,"1,546"
E01004922 : Bolton 015E,"2,254",361,164,197,"1,893",139,"1,754"
E01004822 : Bolton 016B,"1,849",328,191,137,"1,521",63,"1,458"
E01004823 : Bolton 016C,"2,048",521,298,223,"1,527",91,"1,436"
E01004848 : Bolton 016D,"2,090",535,313,222,"1,555",108,"1,447"
E01033217 : Bolton 016E,"1,226",300,135,165,926,48,878
E01033220 : Bolton 016F,"1,313",341,161,180,972,56,916
E01004818 : Bolton 017A,"1,724",368,189,179,"1,356",93,"1,263"
E01004819 : Bolton 017B,"1,518",316,176,140,"1,202",89,"1,113"
E01004928 : Bolton 017C,"1,378",286,143,143,"1,092",101,991
E01004930 : Bolton 017D,"1,514",265,92,173,"1,249",111,"1,138"
E01004931 : Bolton 017E,"1,564",383,195,188,"1,181",108,"1,073"
E01004932 : Bolton 017F,"1,481",330,152,178,"1,151",113,"1,038"
E01004834 : Bolton 018A,"1,746",230,108,122,"1,516",80,"1,436"
E01004838 : Bolton 018B,"2,008",387,210,177,"1,621",73,"1,548"
E01004843 : Bolton 018C,"1,558",214,91,123,"1,344",127,"1,217"
E01004845 : Bolton 018D,"1,870",273,134,139,"1,597",148,"1,449"
E01004923 : Bolton 018E,"1,675",252,98,154,"1,423",103,"1,320"
E01004796 : Bolton 019A,"1,575",293,127,166,"1,282",98,"1,184"
E01004798 : Bolton 019B,"1,613",346,161,185,"1,267",93,"1,174"
E01004799 : Bolton 019C,"1,273",271,122,149,"1,002",94,908
E01004800 : Bolton 019D,"1,291",228,84,144,"1,063",102,961
E01004801 : Bolton 019E,"1,674",425,188,237,"1,249",80,"1,169"
E01004917 : Bolton 019F,"2,299",428,209,219,"1,871",139,"1,732"
E01004835 : Bolton 020A,"1,462",224,88,136,"1,238",97,"1,141"
E01004836 : Bolton 020B,"1,744",306,130,176,"1,438",120,"1,318"
E01004837 : Bolton 020C,"1,561",211,93,118,"1,350",105,"1,245"
E01004844 : Bolton 020D,"1,573",180,74,106,"1,393",136,"1,257"
E01004897 : Bolton 020E,"1,013",157,67,90,856,74,782
E01004827 : Bolton 021A,"1,993",317,159,158,"1,676",67,"1,609"
E01004849 : Bolton 021B,"1,795",222,124,98,"1,573",52,"1,521"
E01004850 : Bolton 021C,"2,293",305,175,130,"1,988",61,"1,927"
E01004851 : Bolton 021D,"1,691",321,189,132,"1,370",43,"1,327"
E01004853 : Bolton 021E,"1,574",262,138,124,"1,312",43,"1,269"
E01004811 : Bolton 022A,"1,845",326,175,151,"1,519",46,"1,473"
E01004812 : Bolton 022B,"2,399",318,154,164,"2,081",73,"2,008"
E01004813 : Bolton 022C,"1,749",286,171,115,"1,463",55,"1,408"
E01004815 : Bolton 022D,"1,785",241,118,123,"1,544",64,"1,480"
E01004817 : Bolton 022E,"2,064",358,156,202,"1,706",139,"1,567"
E01004828 : Bolton 023A,"2,019",301,149,152,"1,718",68,"1,650"
E01004829 : Bolton 023B,"1,458",205,108,97,"1,253",66,"1,187"
E01004832 : Bolton 023C,"1,641",261,114,147,"1,380",86,"1,294"
E01004854 : Bolton 023D,"1,658",254,146,108,"1,404",38,"1,366"
E01004878 : Bolton 023E,"1,697",218,114,104,"1,479",81,"1,398"
E01004911 : Bolton 024A,"1,539",367,168,199,"1,172",133,"1,039"
E01004912 : Bolton 024B,"1,436",311,150,161,"1,125",108,"1,017"
E01004913 : Bolton 024C,"1,955",351,140,211,"1,604",127,"1,477"
E01004914 : Bolton 024D,"1,173",253,101,152,920,90,830
E01004915 : Bolton 024E,"1,274",245,103,142,"1,029",107,922
E01004916 : Bolton 024F,"1,467",376,188,188,"1,091",99,992
E01004918 : Bolton 024G,"1,225",204,87,117,"1,021",119,902
E01004846 : Bolton 025A,"1,410",200,110,90,"1,210",45,"1,165"
E01004847 : Bolton 025B,"2,281",371,206,165,"1,910",82,"1,828"
E01004852 : Bolton 025C,"1,732",218,104,114,"1,514",52,"1,462"
E01004877 : Bolton 025D,"2,076",359,190,169,"1,717",53,"1,664"
E01004879 : Bolton 025E,"1,657",250,148,102,"1,407",49,"1,358"
E01004830 : Bolton 026A,"1,754",350,188,162,"1,404",80,"1,324"
E01004831 : Bolton 026B,"1,827",248,104,144,"1,579",96,"1,483"
E01004833 : Bolton 026C,"1,529",254,118,136,"1,275",94,"1,181"
E01004839 : Bolton 026D,"2,370",498,252,246,"1,872",108,"1,764"
E01004814 : Bolton 027A,"1,604",259,137,122,"1,345",75,"1,270"
E01004855 : Bolton 027B,"1,482",274,130,144,"1,208",90,"1,118"
E01004856 : Bolton 027C,"1,537",326,148,178,"1,211",71,"1,140"
E01004857 : Bolton 027D,"1,902",312,157,155,"1,590",80,"1,510"
E01004891 : Bolton 028A,"1,540",280,119,161,"1,260",125,"1,135"
E01004893 : Bolton 028B,"1,526",236,98,138,"1,290",135,"1,155"
E01004894 : Bolton 028C,"1,925",337,158,179,"1,588",118,"1,470"
E01004901 : Bolton 028E,"1,764",255,98,157,"1,509",136,"1,373"
E01033218 : Bolton 028F,"1,573",193,83,110,"1,380",101,"1,279"
E01033219 : Bolton 028G,"1,421",189,80,109,"1,232",95,"1,137"
E01004816 : Bolton 029A,"2,937",333,160,173,"2,604",74,"2,530"
E01004872 : Bolton 029B,"1,694",309,158,151,"1,385",97,"1,288"
E01004873 : Bolton 029C,"2,021",332,159,173,"1,689",75,"1,614"
E01004875 : Bolton 029D,"1,671",306,140,166,"1,365",98,"1,267"
E01004880 : Bolton 029E,"1,480",198,77,121,"1,282",72,"1,210"
E01004892 : Bolton 030A,"1,581",271,111,160,"1,310",130,"1,180"
E01004896 : Bolton 030B,"1,314",271,150,121,"1,043",96,947
E01004899 : Bolton 030C,"1,596",276,135,141,"1,320",96,"1,224"
E01004900 : Bolton 030D,"1,615",227,97,130,"1,388",74,"1,314"
E01004776 : Bolton 031A,"1,822",379,149,230,"1,443",126,"1,317"
E01004895 : Bolton 031B,"1,325",330,162,168,995,98,897
E01004936 : Bolton 031C,"2,173",432,202,230,"1,741",152,"1,589"
E01004938 : Bolton 031D,"1,548",376,212,164,"1,172",99,"1,073"
E01004939 : Bolton 031E,"1,599",332,156,176,"1,267",104,"1,163"
E01004858 : Bolton 032A,"1,584",389,184,205,"1,195",93,"1,102"
E01004859 : Bolton 032B,"1,507",427,254,173,"1,080",58,"1,022"
E01004860 : Bolton 032C,"1,470",298,142,156,"1,172",94,"1,078"
E01004902 : Bolton 032D,"1,847",384,177,207,"1,463",136,"1,327"
E01004906 : Bolton 032E,"1,795",453,256,197,"1,342",108,"1,234"
E01004861 : Bolton 033A,"1,962",376,184,192,"1,586",103,"1,483"
E01004862 : Bolton 033B,"1,436",347,174,173,"1,089",68,"1,021"
E01004863 : Bolton 033C,"1,586",402,222,180,"1,184",93,"1,091"
E01004874 : Bolton 033D,"1,755",328,149,179,"1,427",111,"1,316"
E01004876 : Bolton 033E,"1,968",453,242,211,"1,515",135,"1,380"
E01004903 : Bolton 034A,"1,443",175,73,102,"1,268",97,"1,171"
E01004904 : Bolton 034B,"1,681",262,110,152,"1,419",133,"1,286"
E01004905 : Bolton 034C,"1,595",310,149,161,"1,285",101,"1,184"
E01004907 : Bolton 034D,"1,309",299,119,180,"1,010",77,933
E01004908 : Bolton 034E,"1,296",268,126,142,"1,028",88,940
E01004909 : Bolton 034F,"1,397",331,152,179,"1,066",78,988
E01004910 : Bolton 034G,"2,051",296,139,157,"1,755",134,"1,621"
E01004933 : Bolton 035A,"1,314",218,92,126,"1,096",100,996
E01004934 : Bolton 035B,"1,442",241,101,140,"1,201",118,"1,083"
E01004935 : Bolton 035C,"1,838",270,111,159,"1,568",131,"1,437"
E01004937 : Bolton 035D,"1,637",221,75,146,"1,416",123,"1,293"
E01004940 : Bolton 035E,"1,431",288,136,152,"1,143",129,"1,014"
E01005014 : Bury 001A,"1,464",257,105,152,"1,207",121,"1,086"
E01005015 : Bury 001B,"1,493",334,168,166,"1,159",117,"1,042"
E01005016 : Bury 001C,"1,497",247,84,163,"1,250",158,"1,092"
E01005017 : Bury 001D,"1,835",261,116,145,"1,574",142,"1,432"
E01005018 : Bury 001E,"1,533",245,99,146,"1,288",125,"1,163"
E01005021 : Bury 001F,"1,218",130,46,84,"1,088",105,983
E01005019 : Bury 002A,"1,502",237,92,145,"1,265",131,"1,134"
E01005023 : Bury 002B,"1,278",277,128,149,"1,001",125,876
E01005046 : Bury 002C,"1,481",236,90,146,"1,245",132,"1,113"
E01005048 : Bury 002D,"1,658",209,59,150,"1,449",131,"1,318"
E01005020 : Bury 003A,"1,362",166,51,115,"1,196",125,"1,071"
E01005022 : Bury 003B,"1,497",205,52,153,"1,292",146,"1,146"
E01005047 : Bury 003C,"1,476",313,157,156,"1,163",126,"1,037"
E01005049 : Bury 003D,"1,643",279,113,166,"1,364",132,"1,232"
E01005051 : Bury 003E,"1,524",335,148,187,"1,189",135,"1,054"
E01004976 : Bury 004A,"1,546",357,203,154,"1,189",101,"1,088"
E01004977 : Bury 004B,"1,708",448,218,230,"1,260",112,"1,148"
E01004978 : Bury 004C,"1,857",356,157,199,"1,501",124,"1,377"
E01004981 : Bury 004D,"1,474",328,159,169,"1,146",96,"1,050"
E01004982 : Bury 004E,"1,488",279,97,182,"1,209",114,"1,095"
E01004961 : Bury 005A,"1,449",284,118,166,"1,165",123,"1,042"
E01004965 : Bury 005B,"1,238",204,84,120,"1,034",100,934
E01004966 : Bury 005C,"1,816",378,171,207,"1,438",133,"1,305"
E01004967 : Bury 005D,"1,191",169,75,94,"1,022",94,928
E01004963 : Bury 006A,"1,478",276,121,155,"1,202",123,"1,079"
E01004968 : Bury 006B,"1,484",233,91,142,"1,251",135,"1,116"
E01005050 : Bury 006C,"2,125",311,107,204,"1,814",145,"1,669"
E01005052 : Bury 006D,"1,443",235,94,141,"1,208",128,"1,080"
E01005053 : Bury 006E,"1,529",300,132,168,"1,229",108,"1,121"
E01004954 : Bury 007A,"1,450",285,118,167,"1,165",109,"1,056"
E01004955 : Bury 007B,"1,358",285,133,152,"1,073",96,977
E01004956 : Bury 007C,"1,776",425,209,216,"1,351",134,"1,217"
E01004957 : Bury 007D,"1,900",421,196,225,"1,479",94,"1,385"
E01004960 : Bury 007E,"1,670",404,196,208,"1,266",82,"1,184"
E01004958 : Bury 008A,"1,508",341,164,177,"1,167",103,"1,064"
E01004959 : Bury 008B,"1,734",338,167,171,"1,396",102,"1,294"
E01004979 : Bury 008C,"1,812",368,200,168,"1,444",76,"1,368"
E01004980 : Bury 008D,"1,454",252,111,141,"1,202",73,"1,129"
E01005024 : Bury 008E,"2,649",417,196,221,"2,232",129,"2,103"
E01005026 : Bury 008F,"2,197",254,130,124,"1,943",84,"1,859"
E01004947 : Bury 009A,"1,547",340,145,195,"1,207",103,"1,104"
E01004948 : Bury 009B,"1,870",440,209,231,"1,430",138,"1,292"
E01004962 : Bury 009C,"2,013",294,114,180,"1,719",133,"1,586"
E01004964 : Bury 009D,"1,852",355,165,190,"1,497",123,"1,374"
E01004949 : Bury 010A,"1,413",188,86,102,"1,225",124,"1,101"
E01004950 : Bury 010B,"1,488",214,91,123,"1,274",138,"1,136"
E01004951 : Bury 010C,"1,562",307,127,180,"1,255",117,"1,138"
E01004952 : Bury 010D,"1,337",246,97,149,"1,091",123,968
E01004953 : Bury 010E,"1,533",260,107,153,"1,273",92,"1,181"
E01005025 : Bury 011A,"1,699",311,142,169,"1,388",110,"1,278"
E01005027 : Bury 011B,"1,860",325,136,189,"1,535",94,"1,441"
E01005028 : Bury 011C,"2,233",466,232,234,"1,767",88,"1,679"
E01005029 : Bury 011D,"1,981",323,155,168,"1,658",112,"1,546"
E01005000 : Bury 012A,"1,471",246,117,129,"1,225",126,"1,099"
E01005001 : Bury 012B,"1,280",174,78,96,"1,106",105,"1,001"
E01005005 : Bury 012C,"1,410",213,82,131,"1,197",122,"1,075"
E01005006 : Bury 012D,"2,024",363,152,211,"1,661",120,"1,541"
E01005030 : Bury 013A,"1,786",403,187,216,"1,383",104,"1,279"
E01005054 : Bury 013B,"1,572",288,135,153,"1,284",119,"1,165"
E01005059 : Bury 013C,"1,787",297,147,150,"1,490",108,"1,382"
E01005060 : Bury 013D,"1,734",257,117,140,"1,477",140,"1,337"
E01004997 : Bury 014A,"1,550",382,198,184,"1,168",121,"1,047"
E01004998 : Bury 014B,"1,658",340,147,193,"1,318",133,"1,185"
E01004999 : Bury 014C,"1,474",279,120,159,"1,195",107,"1,088"
E01005002 : Bury 014D,"1,505",285,118,167,"1,220",102,"1,118"
E01005003 : Bury 014E,"1,485",345,173,172,"1,140",89,"1,051"
E01004991 : Bury 015A,"1,382",250,95,155,"1,132",94,"1,038"
E01004992 : Bury 015B,"1,427",268,127,141,"1,159",91,"1,068"
E01004993 : Bury 015C,"1,990",342,152,190,"1,648",137,"1,511"
E01004994 : Bury 015D,"1,383",255,113,142,"1,128",72,"1,056"
E01004990 : Bury 016A,"1,587",320,160,160,"1,267",90,"1,177"
E01004996 : Bury 016B,"1,509",423,225,198,"1,086",87,999
E01005004 : Bury 016C,"1,582",528,278,250,"1,054",88,966
E01005008 : Bury 016D,"2,172",510,267,243,"1,662",139,"1,523"
E01005009 : Bury 016E,"1,766",396,171,225,"1,370",122,"1,248"
E01004945 : Bury 017A,"1,536",300,123,177,"1,236",117,"1,119"
E01005055 : Bury 017B,"1,448",246,85,161,"1,202",108,"1,094"
E01005056 : Bury 017C,"1,273",250,98,152,"1,023",103,920
E01005057 : Bury 017D,"1,618",225,92,133,"1,393",102,"1,291"
E01005058 : Bury 017E,"1,346",196,79,117,"1,150",108,"1,042"
E01004995 : Bury 018A,"1,501",270,120,150,"1,231",109,"1,122"
E01005010 : Bury 018B,"1,605",247,112,135,"1,358",117,"1,241"
E01005012 : Bury 018C,"1,756",347,152,195,"1,409",108,"1,301"
E01005013 : Bury 018D,"2,622",446,183,263,"2,176",166,"2,010"
E01004984 : Bury 019A,"1,394",221,88,133,"1,173",113,"1,060"
E01004985 : Bury 019B,"1,462",211,84,127,"1,251",115,"1,136"
E01004989 : Bury 019C,"1,421",227,95,132,"1,194",125,"1,069"
E01005007 : Bury 019D,"1,509",352,176,176,"1,157",137,"1,020"
E01005011 : Bury 019E,"1,431",200,77,123,"1,231",105,"1,126"
E01004983 : Bury 020A,"1,355",207,75,132,"1,148",109,"1,039"
E01004986 : Bury 020B,"1,627",328,132,196,"1,299",154,"1,145"
E01004987 : Bury 020C,"1,310",414,229,185,896,80,816
E01004988 : Bury 020D,"1,387",281,107,174,"1,106",115,991
E01004941 : Bury 021A,"1,869",353,174,179,"1,516",98,"1,418"
E01004942 : Bury 021B,"1,700",361,176,185,"1,339",90,"1,249"
E01004943 : Bury 021C,"1,837",296,115,181,"1,541",127,"1,414"
E01004944 : Bury 021D,"1,517",220,77,143,"1,297",129,"1,168"
E01004946 : Bury 021E,"1,679",469,242,227,"1,210",97,"1,113"
E01004969 : Bury 022A,"1,509",351,188,163,"1,158",112,"1,046"
E01004970 : Bury 022B,"1,626",267,101,166,"1,359",123,"1,236"
E01004971 : Bury 022C,"1,477",240,87,153,"1,237",113,"1,124"
E01005034 : Bury 022D,"1,789",354,162,192,"1,435",147,"1,288"
E01004972 : Bury 023A,"1,494",330,157,173,"1,164",88,"1,076"
E01004973 : Bury 023B,"1,546",234,86,148,"1,312",106,"1,206"
E01004975 : Bury 023C,"1,498",289,125,164,"1,209",137,"1,072"
E01005039 : Bury 023D,"1,576",406,206,200,"1,170",118,"1,052"
E01005045 : Bury 023E,"1,619",302,131,171,"1,317",134,"1,183"
E01004974 : Bury 024A,"1,410",200,66,134,"1,210",122,"1,088"
E01005033 : Bury 024B,"1,675",228,82,146,"1,447",116,"1,331"
E01005036 : Bury 024C,"1,981",457,213,244,"1,524",141,"1,383"
E01005037 : Bury 024D,"1,493",247,96,151,"1,246",128,"1,118"
E01005031 : Bury 025A,"1,532",311,128,183,"1,221",94,"1,127"
E01005032 : Bury 025B,"1,342",407,265,142,935,70,865
E01005035 : Bury 025C,"1,455",242,98,144,"1,213",129,"1,084"
E01005038 : Bury 025D,"1,357",200,88,112,"1,157",95,"1,062"
E01005040 : Bury 026A,"1,845",322,135,187,"1,523",128,"1,395"
E01005041 : Bury 026B,"1,857",259,113,146,"1,598",99,"1,499"
E01005042 : Bury 026C,"1,953",248,103,145,"1,705",118,"1,587"
E01005043 : Bury 026D,"1,947",174,76,98,"1,773",96,"1,677"
E01005044 : Bury 026E,"1,965",242,92,150,"1,723",81,"1,642"
E01005098 : Manchester 001A,"1,632",399,222,177,"1,233",70,"1,163"
E01005099 : Manchester 001B,"1,943",412,236,176,"1,531",79,"1,452"
E01005100 : Manchester 001C,"1,658",362,191,171,"1,296",97,"1,199"
E01005102 : Manchester 001D,"1,370",254,107,147,"1,116",91,"1,025"
E01005103 : Manchester 001E,"1,832",444,259,185,"1,388",89,"1,299"
E01005101 : Manchester 002A,"1,871",421,223,198,"1,450",98,"1,352"
E01005135 : Manchester 002B,"1,866",395,191,204,"1,471",80,"1,391"
E01005136 : Manchester 002C,"1,510",352,202,150,"1,158",58,"1,100"
E01005138 : Manchester 002D,"2,480",457,240,217,"2,023",103,"1,920"
E01034107 : Manchester 002F,"1,412",212,96,116,"1,200",81,"1,119"
E01034108 : Manchester 002G,"2,074",346,185,161,"1,728",108,"1,620"
E01005139 : Manchester 003B,"1,966",331,149,182,"1,635",121,"1,514"
E01005141 : Manchester 003C,"1,974",507,282,225,"1,467",90,"1,377"
E01005251 : Manchester 003D,"1,678",302,145,157,"1,376",86,"1,290"
E01005252 : Manchester 003E,"1,930",472,270,202,"1,458",107,"1,351"
E01033685 : Manchester 003F,"1,587",231,124,107,"1,356",74,"1,282"
E01033687 : Manchester 003G,"1,341",430,262,168,911,61,850
E01005104 : Manchester 004A,"1,975",352,178,174,"1,623",80,"1,543"
E01005160 : Manchester 004B,"1,974",288,135,153,"1,686",91,"1,595"
E01005161 : Manchester 004C,"1,814",292,122,170,"1,522",87,"1,435"
E01005162 : Manchester 004D,"1,897",346,173,173,"1,551",91,"1,460"
E01005163 : Manchester 004E,"1,786",301,141,160,"1,485",75,"1,410"
E01005247 : Manchester 005A,"1,421",292,146,146,"1,129",84,"1,045"
E01005248 : Manchester 005B,"1,326",266,117,149,"1,060",89,971
E01005249 : Manchester 005C,"2,199",435,204,231,"1,764",108,"1,656"
E01005250 : Manchester 005D,"2,233",415,214,201,"1,818",99,"1,719"
E01005253 : Manchester 005E,"1,706",377,190,187,"1,329",57,"1,272"
E01005254 : Manchester 005F,"1,606",294,122,172,"1,312",109,"1,203"
E01005164 : Manchester 006A,"2,343",428,252,176,"1,915",78,"1,837"
E01005205 : Manchester 006B,"2,194",456,264,192,"1,738",92,"1,646"
E01005206 : Manchester 006C,"1,875",332,175,157,"1,543",100,"1,443"
E01005207 : Manchester 006D,"2,020",290,139,151,"1,730",75,"1,655"
E01005223 : Manchester 007A,"1,615",270,128,142,"1,345",90,"1,255"
E01005224 : Manchester 007B,"2,118",293,155,138,"1,825",84,"1,741"
E01005225 : Manchester 007C,"2,092",476,288,188,"1,616",81,"1,535"
E01005226 : Manchester 007D,"1,939",262,115,147,"1,677",68,"1,609"
E01005229 : Manchester 007E,"1,501",275,118,157,"1,226",95,"1,131"
E01005145 : Manchester 008A,"3,002",398,203,195,"2,604",61,"2,543"
E01005149 : Manchester 008C,"2,184",264,131,133,"1,920",41,"1,879"
E01005165 : Manchester 008D,"2,349",411,225,186,"1,938",86,"1,852"
E01005166 : Manchester 008E,"2,140",367,176,191,"1,773",67,"1,706"
E01005167 : Manchester 008F,"2,315",325,143,182,"1,990",54,"1,936"
E01034109 : Manchester 008G,"1,525",178,79,99,"1,347",49,"1,298"
E01034110 : Manchester 008H,"1,496",195,88,107,"1,301",44,"1,257"
E01005202 : Manchester 009A,"2,383",494,301,193,"1,889",64,"1,825"
E01005203 : Manchester 009B,"2,024",458,241,217,"1,566",79,"1,487"
E01005227 : Manchester 009D,"2,078",367,203,164,"1,711",68,"1,643"
E01005228 : Manchester 009E,"2,249",404,236,168,"1,845",59,"1,786"
E01033678 : Manchester 009F,"1,776",289,155,134,"1,487",72,"1,415"
E01033679 : Manchester 009G,"1,397",327,207,120,"1,070",48,"1,022"
E01005256 : Manchester 011A,"2,640",519,308,211,"2,121",129,"1,992"
E01005257 : Manchester 011B,"2,009",443,248,195,"1,566",86,"1,480"
E01005258 : Manchester 011C,"1,798",464,272,192,"1,334",90,"1,244"
E01005259 : Manchester 011D,"1,773",401,226,175,"1,372",85,"1,287"
E01005260 : Manchester 011E,"1,468",326,189,137,"1,142",80,"1,062"
E01005093 : Manchester 012A,"1,842",414,246,168,"1,428",64,"1,364"
E01005094 : Manchester 012B,"1,693",320,182,138,"1,373",69,"1,304"
E01005097 : Manchester 012C,"1,950",397,209,188,"1,553",54,"1,499"
E01005255 : Manchester 012D,"1,662",415,231,184,"1,247",57,"1,190"
E01005261 : Manchester 012E,"1,786",405,231,174,"1,381",86,"1,295"
E01005092 : Manchester 015A,"1,944",390,217,173,"1,554",64,"1,490"
E01005105 : Manchester 015C,"2,954",403,201,202,"2,551",122,"2,429"
E01005106 : Manchester 015D,"2,334",425,234,191,"1,909",109,"1,800"
E01005107 : Manchester 015E,"2,033",415,227,188,"1,618",76,"1,542"
E01033668 : Manchester 015F,"1,154",201,89,112,953,72,881
E01033669 : Manchester 015G,"1,427",319,169,150,"1,108",53,"1,055"
E01005189 : Manchester 017D,"1,688",465,241,224,"1,223",65,"1,158"
E01005190 : Manchester 017E,"2,449",413,202,211,"2,036",100,"1,936"
E01034111 : Manchester 017G,"1,571",333,180,153,"1,238",35,"1,203"
E01034112 : Manchester 017H,"1,853",301,149,152,"1,552",95,"1,457"
E01034113 : Manchester 017I,"1,486",238,136,102,"1,248",60,"1,188"
E01034114 : Manchester 017J,"1,918",347,172,175,"1,571",98,"1,473"
E01005061 : Manchester 018A,"1,791",363,193,170,"1,428",67,"1,361"
E01005063 : Manchester 018C,"2,121",371,193,178,"1,750",85,"1,665"
E01005065 : Manchester 018D,"2,170",364,177,187,"1,806",103,"1,703"
E01005066 : Manchester 018E,"1,055",182,80,102,873,33,840
E01034115 : Manchester 018F,"1,894",259,101,158,"1,635",96,"1,539"
E01034116 : Manchester 018G,"1,109",146,65,81,963,49,914
E01005208 : Manchester 019A,"2,811",421,144,277,"2,390",190,"2,200"
E01005210 : Manchester 019C,"2,646",404,131,273,"2,242",164,"2,078"
E01005214 : Manchester 019D,"2,389",308,103,205,"2,081",152,"1,929"
E01034117 : Manchester 019E,"2,201",280,56,224,"1,921",109,"1,812"
E01034118 : Manchester 019F,"1,027",209,108,101,818,44,774
E01005067 : Manchester 020A,"2,075",328,190,138,"1,747",64,"1,683"
E01005186 : Manchester 020B,"2,896",579,353,226,"2,317",108,"2,209"
E01005232 : Manchester 020C,"1,926",327,173,154,"1,599",60,"1,539"
E01005235 : Manchester 020D,"2,079",387,209,178,"1,692",51,"1,641"
E01005239 : Manchester 020E,"1,803",384,194,190,"1,419",71,"1,348"
E01005187 : Manchester 021A,"2,244",356,178,178,"1,888",89,"1,799"
E01005188 : Manchester 021B,"1,920",346,159,187,"1,574",86,"1,488"
E01005191 : Manchester 021C,"1,860",336,174,162,"1,524",83,"1,441"
E01005192 : Manchester 021D,"1,732",309,155,154,"1,423",90,"1,333"
E01005193 : Manchester 021E,"1,770",370,170,200,"1,400",95,"1,305"
E01005230 : Manchester 022B,"2,094",358,130,228,"1,736",114,"1,622"
E01005231 : Manchester 022C,"2,504",393,130,263,"2,111",181,"1,930"
E01005236 : Manchester 022D,"2,266",315,132,183,"1,951",101,"1,850"
E01005237 : Manchester 022E,"2,036",321,151,170,"1,715",70,"1,645"
E01034119 : Manchester 022H,"2,666",436,185,251,"2,230",157,"2,073"
E01005195 : Manchester 023A,"2,447",433,209,224,"2,014",95,"1,919"
E01005197 : Manchester 023C,"1,727",360,196,164,"1,367",68,"1,299"
E01005198 : Manchester 023D,"2,048",407,207,200,"1,641",68,"1,573"
E01005201 : Manchester 023E,"2,124",287,133,154,"1,837",74,"1,763"
E01034120 : Manchester 023F,"1,777",314,173,141,"1,463",49,"1,414"
E01034121 : Manchester 023G,"1,424",183,78,105,"1,241",53,"1,188"
E01005243 : Manchester 024B,"2,909",463,234,229,"2,446",136,"2,310"
E01005245 : Manchester 024C,"2,806",448,212,236,"2,358",80,"2,278"
E01005246 : Manchester 024D,"2,542",311,160,151,"2,231",73,"2,158"
E01034122 : Manchester 024E,"1,868",232,99,133,"1,636",83,"1,553"
E01034123 : Manchester 024F,"1,761",314,148,166,"1,447",62,"1,385"
E01005244 : Manchester 025C,"2,992",445,138,307,"2,547",133,"2,414"
E01005285 : Manchester 025D,"1,536",263,132,131,"1,273",70,"1,203"
E01005288 : Manchester 025E,"1,823",284,108,176,"1,539",106,"1,433"
E01034124 : Manchester 025F,"1,568",219,96,123,"1,349",65,"1,284"
E01034125 : Manchester 025G,"1,556",198,75,123,"1,358",39,"1,319"
E01034126 : Manchester 025H,"1,655",196,65,131,"1,459",64,"1,395"
E01034127 : Manchester 025I,"1,361",215,71,144,"1,146",93,"1,053"
E01005280 : Manchester 026A,"2,177",345,180,165,"1,832",73,"1,759"
E01005281 : Manchester 026B,"2,573",444,121,323,"2,129",178,"1,951"
E01005284 : Manchester 026C,"2,598",370,114,256,"2,228",144,"2,084"
E01005286 : Manchester 026D,"2,300",355,117,238,"1,945",195,"1,750"
E01005287 : Manchester 026E,"2,347",455,250,205,"1,892",88,"1,804"
E01005297 : Manchester 028A,"2,436",472,219,253,"1,964",146,"1,818"
E01005298 : Manchester 028B,"1,815",251,104,147,"1,564",100,"1,464"
E01005302 : Manchester 028C,"2,110",403,187,216,"1,707",132,"1,575"
E01033680 : Manchester 028E,"1,261",244,106,138,"1,017",70,947
E01033686 : Manchester 028F,"1,318",240,102,138,"1,078",84,994
E01005150 : Manchester 029A,"1,692",294,103,191,"1,398",164,"1,234"
E01005151 : Manchester 029B,"1,477",288,118,170,"1,189",137,"1,052"
E01005152 : Manchester 029C,"1,436",175,42,133,"1,261",124,"1,137"
E01005159 : Manchester 029D,"1,610",256,83,173,"1,354",156,"1,198"
E01005296 : Manchester 029E,"1,567",251,98,153,"1,316",116,"1,200"
E01005299 : Manchester 029F,"1,579",233,106,127,"1,346",119,"1,227"
E01005178 : Manchester 030A,"2,010",351,156,195,"1,659",115,"1,544"
E01005179 : Manchester 030B,"2,230",366,169,197,"1,864",146,"1,718"
E01005180 : Manchester 030C,"1,918",427,237,190,"1,491",89,"1,402"
E01005181 : Manchester 030D,"2,226",417,231,186,"1,809",86,"1,723"
E01005182 : Manchester 030E,"1,619",296,138,158,"1,323",53,"1,270"
E01005183 : Manchester 030F,"1,793",423,225,198,"1,370",75,"1,295"
E01005219 : Manchester 031A,"2,279",398,181,217,"1,881",124,"1,757"
E01005220 : Manchester 031B,"2,137",296,128,168,"1,841",140,"1,701"
E01005221 : Manchester 031C,"2,557",368,141,227,"2,189",122,"2,067"
E01005222 : Manchester 031D,"2,164",423,221,202,"1,741",127,"1,614"
E01005184 : Manchester 032A,"2,295",348,102,246,"1,947",129,"1,818"
E01005185 : Manchester 032B,"3,260",456,67,389,"2,804",244,"2,560"
E01005271 : Manchester 032C,"1,985",327,79,248,"1,658",140,"1,518"
E01034128 : Manchester 032F,"3,735",546,180,366,"3,189",236,"2,953"
E01005154 : Manchester 033A,"1,427",216,90,126,"1,211",147,"1,064"
E01005156 : Manchester 033B,"1,478",207,72,135,"1,271",137,"1,134"
E01005158 : Manchester 033C,"1,489",291,123,168,"1,198",101,"1,097"
E01005300 : Manchester 033D,"1,547",241,107,134,"1,306",84,"1,222"
E01005301 : Manchester 033E,"1,482",210,66,144,"1,272",113,"1,159"
E01005118 : Manchester 034A,"1,472",230,113,117,"1,242",68,"1,174"
E01005120 : Manchester 034B,"1,901",351,174,177,"1,550",110,"1,440"
E01005215 : Manchester 034C,"2,044",322,138,184,"1,722",94,"1,628"
E01005216 : Manchester 034D,"1,529",232,90,142,"1,297",106,"1,191"
E01005217 : Manchester 034E,"2,053",322,143,179,"1,731",101,"1,630"
E01005218 : Manchester 034F,"1,689",352,162,190,"1,337",95,"1,242"
E01005270 : Manchester 035A,"1,768",364,188,176,"1,404",97,"1,307"
E01005272 : Manchester 035B,"1,973",496,299,197,"1,477",112,"1,365"
E01005273 : Manchester 035C,"1,667",299,87,212,"1,368",136,"1,232"
E01005278 : Manchester 035D,"1,853",279,119,160,"1,574",101,"1,473"
E01005279 : Manchester 035E,"2,199",387,163,224,"1,812",107,"1,705"
E01005305 : Manchester 036A,"1,707",236,88,148,"1,471",138,"1,333"
E01005309 : Manchester 036B,"2,227",398,111,287,"1,829",200,"1,629"
E01005310 : Manchester 036C,"1,986",344,128,216,"1,642",140,"1,502"
E01005311 : Manchester 036D,"1,825",268,104,164,"1,557",143,"1,414"
E01005312 : Manchester 036E,"1,982",338,113,225,"1,644",153,"1,491"
E01005082 : Manchester 037A,"1,799",382,198,184,"1,417",95,"1,322"
E01005153 : Manchester 037B,"1,543",244,94,150,"1,299",122,"1,177"
E01005155 : Manchester 037C,"1,434",183,56,127,"1,251",138,"1,113"
E01005157 : Manchester 037D,"1,527",191,51,140,"1,336",132,"1,204"
E01005274 : Manchester 038A,"1,751",362,166,196,"1,389",123,"1,266"
E01005275 : Manchester 038B,"1,780",232,58,174,"1,548",176,"1,372"
E01005276 : Manchester 038C,"1,466",268,108,160,"1,198",145,"1,053"
E01005277 : Manchester 038D,"1,677",185,56,129,"1,492",151,"1,341"
E01005076 : Manchester 039A,"1,348",186,57,129,"1,162",108,"1,054"
E01005081 : Manchester 039C,"1,821",414,220,194,"1,407",86,"1,321"
E01005083 : Manchester 039D,"1,837",192,49,143,"1,645",156,"1,489"
E01033670 : Manchester 039E,"1,446",110,25,85,"1,336",125,"1,211"
E01033671 : Manchester 039F,"1,788",241,118,123,"1,547",157,"1,390"
E01005125 : Manchester 040A,"1,574",298,142,156,"1,276",122,"1,154"
E01005304 : Manchester 040B,"1,959",333,106,227,"1,626",161,"1,465"
E01005306 : Manchester 040C,"1,580",246,77,169,"1,334",150,"1,184"
E01005307 : Manchester 040D,"1,803",295,89,206,"1,508",144,"1,364"
E01005308 : Manchester 040E,"1,687",299,136,163,"1,388",117,"1,271"
E01005119 : Manchester 041A,"1,738",392,217,175,"1,346",78,"1,268"
E01005121 : Manchester 041B,"1,687",393,197,196,"1,294",74,"1,220"
E01005122 : Manchester 041C,"1,911",369,195,174,"1,542",93,"1,449"
E01005123 : Manchester 041D,"1,773",368,182,186,"1,405",93,"1,312"
E01005124 : Manchester 041E,"1,862",382,217,165,"1,480",79,"1,401"
E01005077 : Manchester 042A,"1,676",358,190,168,"1,318",91,"1,227"
E01005078 : Manchester 042B,"1,552",248,107,141,"1,304",134,"1,170"
E01005079 : Manchester 042C,"1,643",286,136,150,"1,357",124,"1,233"
E01005084 : Manchester 042D,"2,009",362,162,200,"1,647",152,"1,495"
E01005172 : Manchester 043A,"1,533",267,98,169,"1,266",147,"1,119"
E01005173 : Manchester 043B,"1,616",205,95,110,"1,411",142,"1,269"
E01005174 : Manchester 043C,"1,553",201,68,133,"1,352",124,"1,228"
E01005175 : Manchester 043D,"1,591",247,121,126,"1,344",103,"1,241"
E01005176 : Manchester 043E,"1,682",220,68,152,"1,462",134,"1,328"
E01005177 : Manchester 043F,"1,303",189,82,107,"1,114",134,980
E01005115 : Manchester 044A,"1,898",366,165,201,"1,532",118,"1,414"
E01005262 : Manchester 044B,"1,784",348,177,171,"1,436",102,"1,334"
E01005264 : Manchester 044C,"1,649",421,228,193,"1,228",90,"1,138"
E01005265 : Manchester 044D,"1,738",394,211,183,"1,344",60,"1,284"
E01005266 : Manchester 044E,"2,053",457,236,221,"1,596",111,"1,485"
E01005126 : Manchester 045A,"2,003",307,131,176,"1,696",146,"1,550"
E01005168 : Manchester 045B,"1,404",174,57,117,"1,230",129,"1,101"
E01005169 : Manchester 045C,"1,368",171,64,107,"1,197",117,"1,080"
E01005170 : Manchester 045D,"1,519",215,87,128,"1,304",116,"1,188"
E01005171 : Manchester 045E,"1,746",267,123,144,"1,479",125,"1,354"
E01005263 : Manchester 046A,"1,736",408,206,202,"1,328",118,"1,210"
E01005267 : Manchester 046B,"1,524",311,148,163,"1,213",106,"1,107"
E01005268 : Manchester 046C,"2,188",378,152,226,"1,810",187,"1,623"
E01005269 : Manchester 046D,"1,536",274,129,145,"1,262",117,"1,145"
E01005069 : Manchester 047A,"1,418",247,135,112,"1,171",105,"1,066"
E01005111 : Manchester 047B,"1,460",315,136,179,"1,145",80,"1,065"
E01005113 : Manchester 047C,"1,672",485,264,221,"1,187",107,"1,080"
E01005114 : Manchester 047D,"1,746",320,132,188,"1,426",143,"1,283"
E01005116 : Manchester 047E,"2,089",413,191,222,"1,676",150,"1,526"
E01005071 : Manchester 048A,"1,735",385,203,182,"1,350",90,"1,260"
E01005072 : Manchester 048B,"1,781",370,182,188,"1,411",95,"1,316"
E01005073 : Manchester 048C,"1,535",267,118,149,"1,268",93,"1,175"
E01005112 : Manchester 048D,"1,723",374,174,200,"1,349",87,"1,262"
E01005117 : Manchester 048E,"2,455",446,213,233,"2,009",115,"1,894"
E01005085 : Manchester 049A,"1,673",381,191,190,"1,292",93,"1,199"
E01005086 : Manchester 049B,"1,908",443,239,204,"1,465",85,"1,380"
E01005089 : Manchester 049C,"1,970",432,241,191,"1,538",95,"1,443"
E01005289 : Manchester 049D,"1,702",485,263,222,"1,217",82,"1,135"
E01005295 : Manchester 049E,"2,641",494,260,234,"2,147",151,"1,996"
E01005087 : Manchester 050A,"2,304",544,284,260,"1,760",106,"1,654"
E01005088 : Manchester 050B,"1,933",469,242,227,"1,464",86,"1,378"
E01005090 : Manchester 050C,"1,891",490,259,231,"1,401",96,"1,305"
E01005091 : Manchester 050D,"2,382",456,215,241,"1,926",121,"1,805"
E01005291 : Manchester 050E,"1,481",360,181,179,"1,121",86,"1,035"
E01005068 : Manchester 051A,"1,690",375,210,165,"1,315",81,"1,234"
E01005070 : Manchester 051B,"1,847",447,223,224,"1,400",113,"1,287"
E01005074 : Manchester 051C,"1,623",391,209,182,"1,232",100,"1,132"
E01005075 : Manchester 051D,"1,550",422,234,188,"1,128",78,"1,050"
E01005319 : Manchester 051E,"2,323",508,261,247,"1,815",103,"1,712"
E01005290 : Manchester 052A,"1,688",409,224,185,"1,279",75,"1,204"
E01005292 : Manchester 052B,"1,523",356,193,163,"1,167",83,"1,084"
E01005293 : Manchester 052C,"1,174",228,103,125,946,85,861
E01005294 : Manchester 052D,"1,617",319,157,162,"1,298",97,"1,201"
E01005317 : Manchester 052E,"2,020",467,242,225,"1,553",135,"1,418"
E01005313 : Manchester 053A,"1,515",327,181,146,"1,188",79,"1,109"
E01005314 : Manchester 053B,"1,695",378,192,186,"1,317",76,"1,241"
E01005315 : Manchester 053C,"1,724",444,219,225,"1,280",87,"1,193"
E01005316 : Manchester 053D,"1,642",312,150,162,"1,330",74,"1,256"
E01005318 : Manchester 053E,"1,989",472,262,210,"1,517",105,"1,412"
E01005130 : Manchester 054A,"1,447",331,169,162,"1,116",73,"1,043"
E01033651 : Manchester 054B,"1,691",193,37,156,"1,498",140,"1,358"
E01033658 : Manchester 054C,"1,394",150,32,118,"1,244",93,"1,151"
E01033664 : Manchester 054D,"1,857",175,30,145,"1,682",147,"1,535"
E01033667 : Manchester 054E,"1,491",233,69,164,"1,258",132,"1,126"
E01005128 : Manchester 055A,"2,026",183,39,144,"1,843",124,"1,719"
E01033653 : Manchester 055B,"1,851",255,84,171,"1,596",174,"1,422"
E01033654 : Manchester 055C,"1,789",175,40,135,"1,614",94,"1,520"
E01033661 : Manchester 055E,"1,988",295,95,200,"1,693",175,"1,518"
E01034129 : Manchester 055F,"1,082",119,9,110,963,98,865
E01034130 : Manchester 055G,"1,391",121,17,104,"1,270",143,"1,127"
E01005143 : Manchester 056A,"3,007",406,209,197,"2,601",80,"2,521"
E01033655 : Manchester 056B,"1,267",102,14,88,"1,165",116,"1,049"
E01033665 : Manchester 056C,"1,524",199,58,141,"1,325",120,"1,205"
E01033676 : Manchester 056D,"2,005",447,230,217,"1,558",71,"1,487"
E01005212 : Manchester 057A,"3,127",522,153,369,"2,605",206,"2,399"
E01033656 : Manchester 057B,"2,716",322,64,258,"2,394",180,"2,214"
E01033662 : Manchester 057C,"2,013",220,58,162,"1,793",125,"1,668"
E01005142 : Manchester 058A,"2,289",405,204,201,"1,884",60,"1,824"
E01005147 : Manchester 058B,"2,782",424,207,217,"2,358",78,"2,280"
E01033674 : Manchester 058C,"2,080",432,184,248,"1,648",168,"1,480"
E01033675 : Manchester 058D,"2,208",314,161,153,"1,894",67,"1,827"
E01005213 : Manchester 059A,"2,395",474,217,257,"1,921",133,"1,788"
E01033660 : Manchester 059B,"1,438",119,13,106,"1,319",124,"1,195"
E01033672 : Manchester 059C,"1,704",288,127,161,"1,416",103,"1,313"
E01033673 : Manchester 059D,"1,444",107,15,92,"1,337",138,"1,199"
E01033677 : Manchester 060A,"1,018",84,12,72,934,72,862
E01033681 : Manchester 060B,"1,331",127,38,89,"1,204",118,"1,086"
E01033682 : Manchester 060C,"1,222",147,41,106,"1,075",109,966
E01034131 : Manchester 060E,"1,025",86,15,71,939,81,858
E01034132 : Manchester 060F,"1,829",144,18,126,"1,685",98,"1,587"
E01005129 : Manchester 061A,"1,842",340,190,150,"1,502",84,"1,418"
E01005132 : Manchester 061B,"2,137",415,203,212,"1,722",102,"1,620"
E01034133 : Manchester 061C,"1,868",389,211,178,"1,479",106,"1,373"
E01034134 : Manchester 061D,"1,192",105,16,89,"1,087",125,962
E01034135 : Manchester 062A,"1,116",124,43,81,992,102,890
E01033688 : Manchester 062B,"1,709",410,235,175,"1,299",88,"1,211"
E01034136 : Manchester 062C,"1,009",101,16,85,908,94,814
E01033684 : Manchester 062D,"1,818",182,22,160,"1,636",162,"1,474"
E01005234 : Manchester 063A,"2,313",292,136,156,"2,021",77,"1,944"
E01005233 : Manchester 063B,"2,933",366,187,179,"2,567",54,"2,513"
E01034137 : Manchester 063C,"1,735",237,119,118,"1,498",65,"1,433"
E01005238 : Manchester 063D,"2,298",305,143,162,"1,993",78,"1,915"
E01005200 : Manchester 064A,"2,460",432,194,238,"2,028",121,"1,907"
E01034138 : Manchester 064B,"1,385",169,78,91,"1,216",38,"1,178"
E01005199 : Manchester 064C,"2,514",360,157,203,"2,154",136,"2,018"
E01005357 : Oldham 001A,"1,424",252,99,153,"1,172",115,"1,057"
E01005358 : Oldham 001B,"1,568",340,155,185,"1,228",114,"1,114"
E01005359 : Oldham 001C,"1,564",331,151,180,"1,233",129,"1,104"
E01005360 : Oldham 001D,"1,380",335,143,192,"1,045",98,947
E01005441 : Oldham 002A,"1,526",404,207,197,"1,122",91,"1,031"
E01005442 : Oldham 002B,"1,329",238,75,163,"1,091",109,982
E01005444 : Oldham 002C,"1,397",309,152,157,"1,088",79,"1,009"
E01005445 : Oldham 002D,"1,425",294,133,161,"1,131",89,"1,042"
E01005361 : Oldham 003A,"1,671",332,149,183,"1,339",126,"1,213"
E01005443 : Oldham 003B,"1,314",197,65,132,"1,117",121,996
E01005446 : Oldham 003C,"1,406",256,101,155,"1,150",102,"1,048"
E01005447 : Oldham 003D,"1,649",515,278,237,"1,134",90,"1,044"
E01005390 : Oldham 004A,"1,361",222,87,135,"1,139",101,"1,038"
E01005394 : Oldham 004B,"1,450",250,95,155,"1,200",127,"1,073"
E01005395 : Oldham 004C,"1,430",253,98,155,"1,177",92,"1,085"
E01005396 : Oldham 004D,"1,432",267,114,153,"1,165",107,"1,058"
E01005355 : Oldham 005A,"1,461",268,122,146,"1,193",101,"1,092"
E01005356 : Oldham 005B,"1,252",202,82,120,"1,050",104,946
E01005399 : Oldham 005C,"1,585",323,153,170,"1,262",117,"1,145"
E01005403 : Oldham 005D,"1,733",244,90,154,"1,489",124,"1,365"
E01005410 : Oldham 006A,"1,496",201,78,123,"1,295",132,"1,163"
E01005411 : Oldham 006B,"1,563",333,133,200,"1,230",124,"1,106"
E01005414 : Oldham 006C,"1,332",183,67,116,"1,149",120,"1,029"
E01005415 : Oldham 006D,"1,109",250,123,127,859,92,767
E01005452 : Oldham 007C,"1,278",213,84,129,"1,065",130,935
E01005453 : Oldham 007D,"1,554",216,81,135,"1,338",115,"1,223"
E01032558 : Oldham 007E,"1,727",341,160,181,"1,386",83,"1,303"
E01032559 : Oldham 007F,"2,751",510,249,261,"2,241",170,"2,071"
E01005391 : Oldham 008A,"1,558",263,108,155,"1,295",112,"1,183"
E01005392 : Oldham 008B,"1,588",420,208,212,"1,168",88,"1,080"
E01005393 : Oldham 008C,"1,221",241,101,140,980,82,898
E01005401 : Oldham 008D,"1,585",283,114,169,"1,302",137,"1,165"
E01005397 : Oldham 009A,"1,326",270,131,139,"1,056",92,964
E01005398 : Oldham 009B,"1,530",277,120,157,"1,253",105,"1,148"
E01005400 : Oldham 009C,"1,526",433,210,223,"1,093",94,999
E01005402 : Oldham 009D,"1,644",261,120,141,"1,383",92,"1,291"
E01005335 : Oldham 010A,"1,290",188,59,129,"1,102",103,999
E01005337 : Oldham 010B,"2,548",312,137,175,"2,236",82,"2,154"
E01005339 : Oldham 010C,"1,485",235,81,154,"1,250",107,"1,143"
E01005340 : Oldham 010D,"1,600",341,175,166,"1,259",85,"1,174"
E01005421 : Oldham 011A,"1,817",430,225,205,"1,387",99,"1,288"
E01005422 : Oldham 011B,"1,551",293,150,143,"1,258",68,"1,190"
E01032920 : Oldham 011E,"2,585",452,206,246,"2,133",156,"1,977"
E01005448 : Oldham 012A,"1,643",387,201,186,"1,256",66,"1,190"
E01005449 : Oldham 012B,"1,585",406,225,181,"1,179",90,"1,089"
E01005454 : Oldham 012C,"1,379",249,115,134,"1,130",96,"1,034"
E01005455 : Oldham 012D,"1,464",222,102,120,"1,242",98,"1,144"
E01005456 : Oldham 012E,"1,680",407,198,209,"1,273",98,"1,175"
E01005407 : Oldham 013A,"1,719",240,87,153,"1,479",147,"1,332"
E01005412 : Oldham 013B,"1,684",250,79,171,"1,434",143,"1,291"
E01005416 : Oldham 013C,"1,521",214,82,132,"1,307",129,"1,178"
E01005417 : Oldham 013D,"1,553",259,111,148,"1,294",110,"1,184"
E01005348 : Oldham 014A,"2,423",432,218,214,"1,991",116,"1,875"
E01005350 : Oldham 014B,"2,408",577,320,257,"1,831",85,"1,746"
E01005432 : Oldham 014C,"1,828",398,196,202,"1,430",73,"1,357"
E01005433 : Oldham 014D,"2,477",423,228,195,"2,054",110,"1,944"
E01005329 : Oldham 015A,"1,499",231,91,140,"1,268",123,"1,145"
E01005330 : Oldham 015B,"1,738",273,112,161,"1,465",95,"1,370"
E01005333 : Oldham 015C,"1,239",188,71,117,"1,051",96,955
E01005336 : Oldham 015D,"1,520",240,101,139,"1,280",102,"1,178"
E01005349 : Oldham 016A,"2,503",292,139,153,"2,211",69,"2,142"
E01005351 : Oldham 016B,"2,085",287,138,149,"1,798",44,"1,754"
E01005352 : Oldham 016C,"1,529",265,145,120,"1,264",40,"1,224"
E01005353 : Oldham 016D,"1,510",240,141,99,"1,270",59,"1,211"
E01005354 : Oldham 016E,"1,804",262,125,137,"1,542",79,"1,463"
E01005327 : Oldham 017A,"1,969",438,231,207,"1,531",120,"1,411"
E01005328 : Oldham 017B,"1,790",438,231,207,"1,352",54,"1,298"
E01005331 : Oldham 017C,"1,727",280,132,148,"1,447",102,"1,345"
E01005334 : Oldham 017D,"1,425",159,53,106,"1,266",105,"1,161"
E01005338 : Oldham 017E,"1,941",450,254,196,"1,491",89,"1,402"
E01005387 : Oldham 018A,"1,473",236,80,156,"1,237",96,"1,141"
E01005388 : Oldham 018B,"1,339",272,127,145,"1,067",100,967
E01005389 : Oldham 018C,"1,767",415,201,214,"1,352",112,"1,240"
E01005418 : Oldham 018D,"1,409",225,84,141,"1,184",118,"1,066"
E01005428 : Oldham 019A,"2,366",251,119,132,"2,115",69,"2,046"
E01005431 : Oldham 019B,"1,862",335,150,185,"1,527",107,"1,420"
E01005450 : Oldham 019C,"2,138",309,156,153,"1,829",60,"1,769"
E01005451 : Oldham 019D,"1,547",227,92,135,"1,320",78,"1,242"
E01005408 : Oldham 020C,"2,018",300,96,204,"1,718",180,"1,538"
E01005409 : Oldham 020D,"1,567",199,68,131,"1,368",133,"1,235"
E01032922 : Oldham 020E,"2,414",443,183,260,"1,971",239,"1,732"
E01005406 : Oldham 021A,"1,409",207,84,123,"1,202",112,"1,090"
E01005413 : Oldham 021B,"1,593",237,68,169,"1,356",133,"1,223"
E01005419 : Oldham 021C,"1,453",273,106,167,"1,180",115,"1,065"
E01005420 : Oldham 021D,"1,615",371,167,204,"1,244",131,"1,113"
E01005321 : Oldham 022A,"2,331",394,225,169,"1,937",38,"1,899"
E01005326 : Oldham 022B,"2,997",562,330,232,"2,435",62,"2,373"
E01005427 : Oldham 022C,"2,214",344,184,160,"1,870",44,"1,826"
E01005429 : Oldham 022D,"1,919",287,154,133,"1,632",55,"1,577"
E01005430 : Oldham 022E,"2,852",346,189,157,"2,506",86,"2,420"
E01005320 : Oldham 024A,"2,700",347,157,190,"2,353",78,"2,275"
E01005434 : Oldham 024B,"2,162",383,199,184,"1,779",65,"1,714"
E01005437 : Oldham 024C,"2,049",272,129,143,"1,777",53,"1,724"
E01005459 : Oldham 024D,"1,769",321,178,143,"1,448",42,"1,406"
E01005383 : Oldham 026A,"2,191",363,174,189,"1,828",86,"1,742"
E01005386 : Oldham 026D,"1,548",354,187,167,"1,194",79,"1,115"
E01032556 : Oldham 026E,"1,502",259,115,144,"1,243",114,"1,129"
E01032557 : Oldham 026F,"1,819",464,231,233,"1,355",111,"1,244"
E01005342 : Oldham 027A,"1,592",371,189,182,"1,221",95,"1,126"
E01005343 : Oldham 027B,"1,415",289,137,152,"1,126",79,"1,047"
E01005344 : Oldham 027C,"1,913",366,169,197,"1,547",114,"1,433"
E01005381 : Oldham 027D,"1,956",402,223,179,"1,554",96,"1,458"
E01005332 : Oldham 028A,"2,296",483,232,251,"1,813",121,"1,692"
E01005341 : Oldham 028B,"1,413",256,116,140,"1,157",94,"1,063"
E01005345 : Oldham 028C,"1,500",268,127,141,"1,232",83,"1,149"
E01005346 : Oldham 028D,"1,393",305,153,152,"1,088",82,"1,006"
E01005347 : Oldham 028E,"1,311",214,92,122,"1,097",101,996
E01005322 : Oldham 029A,"1,508",335,187,148,"1,173",70,"1,103"
E01005323 : Oldham 029B,"1,570",418,210,208,"1,152",74,"1,078"
E01005324 : Oldham 029C,"1,620",374,178,196,"1,246",87,"1,159"
E01005325 : Oldham 029D,"1,497",329,175,154,"1,168",71,"1,097"
E01005438 : Oldham 029E,"2,968",430,177,253,"2,538",128,"2,410"
E01005377 : Oldham 030A,"1,751",377,181,196,"1,374",78,"1,296"
E01005379 : Oldham 030B,"1,296",285,130,155,"1,011",53,958
E01005380 : Oldham 030C,"1,515",337,163,174,"1,178",81,"1,097"
E01005382 : Oldham 030D,"1,609",414,203,211,"1,195",120,"1,075"
E01005439 : Oldham 030E,"1,587",290,129,161,"1,297",100,"1,197"
E01005362 : Oldham 031A,"1,357",240,113,127,"1,117",95,"1,022"
E01005364 : Oldham 031B,"1,584",270,118,152,"1,314",114,"1,200"
E01005368 : Oldham 031C,"1,517",334,153,181,"1,183",91,"1,092"
E01005376 : Oldham 031D,"1,444",317,160,157,"1,127",64,"1,063"
E01005378 : Oldham 031E,"1,556",324,153,171,"1,232",85,"1,147"
E01005363 : Oldham 032A,"1,770",363,180,183,"1,407",117,"1,290"
E01005369 : Oldham 032B,"1,964",386,219,167,"1,578",136,"1,442"
E01005370 : Oldham 032C,"1,578",416,197,219,"1,162",71,"1,091"
E01005371 : Oldham 032D,"1,471",274,114,160,"1,197",84,"1,113"
E01005365 : Oldham 033A,"1,377",236,103,133,"1,141",79,"1,062"
E01005366 : Oldham 033B,"1,557",459,231,228,"1,098",83,"1,015"
E01005367 : Oldham 033C,"1,420",206,96,110,"1,214",105,"1,109"
E01005440 : Oldham 033D,"1,450",304,150,154,"1,146",98,"1,048"
E01005372 : Oldham 034A,"1,277",212,96,116,"1,065",72,993
E01005373 : Oldham 034B,"1,193",204,88,116,989,85,904
E01005374 : Oldham 034C,"1,486",315,158,157,"1,171",88,"1,083"
E01005375 : Oldham 034D,"1,502",252,122,130,"1,250",110,"1,140"
E01034232 : Oldham 036A,"1,692",280,153,127,"1,412",34,"1,378"
E01034233 : Oldham 036B,"1,608",247,118,129,"1,361",47,"1,314"
E01005460 : Oldham 036C,"2,701",367,187,180,"2,334",74,"2,260"
E01005463 : Oldham 036D,"1,687",208,103,105,"1,479",51,"1,428"
E01005461 : Oldham 037A,"2,423",335,167,168,"2,088",64,"2,024"
E01005435 : Oldham 037B,"2,033",286,145,141,"1,747",54,"1,693"
E01005462 : Oldham 037C,"2,204",337,164,173,"1,867",67,"1,800"
E01005436 : Oldham 037D,"1,827",238,110,128,"1,589",74,"1,515"
E01005518 : Rochdale 001A,"1,592",335,142,193,"1,257",102,"1,155"
E01005520 : Rochdale 001B,"1,715",325,117,208,"1,390",142,"1,248"
E01005522 : Rochdale 001C,"1,486",354,159,195,"1,132",130,"1,002"
E01005523 : Rochdale 001D,"1,834",357,152,205,"1,477",145,"1,332"
E01005519 : Rochdale 002A,"1,564",236,79,157,"1,328",105,"1,223"
E01005594 : Rochdale 002B,"1,512",276,137,139,"1,236",94,"1,142"
E01005597 : Rochdale 002C,"1,979",294,114,180,"1,685",139,"1,546"
E01005598 : Rochdale 002D,"1,548",266,106,160,"1,282",138,"1,144"
E01005516 : Rochdale 003A,"1,280",212,95,117,"1,068",113,955
E01005517 : Rochdale 003B,"1,436",295,126,169,"1,141",101,"1,040"
E01005521 : Rochdale 003C,"1,452",262,99,163,"1,190",145,"1,045"
E01005596 : Rochdale 003D,"2,157",336,128,208,"1,821",179,"1,642"
E01005578 : Rochdale 004A,"1,543",329,172,157,"1,214",53,"1,161"
E01005579 : Rochdale 004B,"1,861",343,166,177,"1,518",55,"1,463"
E01005586 : Rochdale 004C,"1,615",350,183,167,"1,265",58,"1,207"
E01005593 : Rochdale 004D,"2,055",350,156,194,"1,705",158,"1,547"
E01005595 : Rochdale 004E,"1,330",408,216,192,922,82,840
E01005489 : Rochdale 005A,"1,250",223,95,128,"1,027",83,944
E01005490 : Rochdale 005B,"1,571",382,164,218,"1,189",94,"1,095"
E01005491 : Rochdale 005C,"1,436",276,124,152,"1,160",107,"1,053"
E01005493 : Rochdale 005D,"1,764",269,113,156,"1,495",118,"1,377"
E01005494 : Rochdale 005E,"1,759",311,152,159,"1,448",107,"1,341"
E01005495 : Rochdale 005F,"1,770",386,178,208,"1,384",104,"1,280"
E01005488 : Rochdale 006A,"1,508",157,57,100,"1,351",104,"1,247"
E01005492 : Rochdale 006B,"1,534",267,103,164,"1,267",110,"1,157"
E01005499 : Rochdale 006C,"1,512",248,113,135,"1,264",114,"1,150"
E01005571 : Rochdale 006D,"1,648",237,83,154,"1,411",146,"1,265"
E01005570 : Rochdale 007A,"1,307",243,119,124,"1,064",111,953
E01005572 : Rochdale 007B,"1,500",231,89,142,"1,269",108,"1,161"
E01005573 : Rochdale 007C,"1,433",199,85,114,"1,234",104,"1,130"
E01005574 : Rochdale 007D,"1,728",253,111,142,"1,475",129,"1,346"
E01005587 : Rochdale 007E,"1,368",157,57,100,"1,211",99,"1,112"
E01005588 : Rochdale 007F,"1,314",370,178,192,944,91,853
E01005580 : Rochdale 008A,"1,647",259,118,141,"1,388",64,"1,324"
E01005581 : Rochdale 008B,"1,971",317,173,144,"1,654",51,"1,603"
E01005583 : Rochdale 008D,"1,746",321,173,148,"1,425",46,"1,379"
E01005585 : Rochdale 008F,"1,566",224,98,126,"1,342",64,"1,278"
E01034234 : Rochdale 008H,"1,762",244,120,124,"1,518",49,"1,469"
E01034235 : Rochdale 008I,"1,668",266,146,120,"1,402",53,"1,349"
E01005496 : Rochdale 009A,"1,321",273,134,139,"1,048",61,987
E01005589 : Rochdale 009B,"1,700",301,136,165,"1,399",90,"1,309"
E01005590 : Rochdale 009C,"1,904",335,158,177,"1,569",105,"1,464"
E01005591 : Rochdale 009D,"1,585",288,120,168,"1,297",119,"1,178"
E01005592 : Rochdale 009E,"1,638",337,170,167,"1,301",87,"1,214"
E01005472 : Rochdale 010A,"1,647",323,169,154,"1,324",77,"1,247"
E01005473 : Rochdale 010B,"1,699",283,160,123,"1,416",86,"1,330"
E01005482 : Rochdale 010C,"1,662",466,281,185,"1,196",78,"1,118"
E01005483 : Rochdale 010D,"1,486",315,146,169,"1,171",61,"1,110"
E01005484 : Rochdale 010E,"2,031",375,191,184,"1,656",66,"1,590"
E01005486 : Rochdale 010F,"1,701",246,118,128,"1,455",50,"1,405"
E01005487 : Rochdale 010G,"1,789",272,138,134,"1,517",58,"1,459"
E01005474 : Rochdale 011A,"1,318",285,149,136,"1,033",54,979
E01005575 : Rochdale 011B,"1,714",308,120,188,"1,406",125,"1,281"
E01005576 : Rochdale 011C,"1,525",230,86,144,"1,295",121,"1,174"
E01005577 : Rochdale 011D,"1,461",236,78,158,"1,225",123,"1,102"
E01005469 : Rochdale 012A,"1,823",306,124,182,"1,517",92,"1,425"
E01005563 : Rochdale 012B,"2,170",340,167,173,"1,830",77,"1,753"
E01005565 : Rochdale 012C,"1,572",329,185,144,"1,243",65,"1,178"
E01005566 : Rochdale 012D,"2,344",405,187,218,"1,939",130,"1,809"
E01005568 : Rochdale 012E,"1,939",414,215,199,"1,525",55,"1,470"
E01005569 : Rochdale 012F,"1,793",358,191,167,"1,435",67,"1,368"
E01005556 : Rochdale 013A,"1,528",308,116,192,"1,220",135,"1,085"
E01005559 : Rochdale 013B,"1,469",369,178,191,"1,100",94,"1,006"
E01005560 : Rochdale 013C,"1,463",330,146,184,"1,133",102,"1,031"
E01005567 : Rochdale 013D,"1,879",327,148,179,"1,552",103,"1,449"
E01005555 : Rochdale 014A,"1,386",208,82,126,"1,178",119,"1,059"
E01005557 : Rochdale 014B,"1,137",213,78,135,924,81,843
E01005558 : Rochdale 014C,"1,594",320,158,162,"1,274",117,"1,157"
E01005561 : Rochdale 014D,"1,409",277,116,161,"1,132",114,"1,018"
E01005562 : Rochdale 014E,"1,508",341,141,200,"1,167",119,"1,048"
E01005470 : Rochdale 015A,"2,036",318,190,128,"1,718",38,"1,680"
E01005471 : Rochdale 015B,"1,697",278,139,139,"1,419",74,"1,345"
E01005475 : Rochdale 015C,"1,778",318,168,150,"1,460",47,"1,413"
E01005485 : Rochdale 015D,"2,375",463,288,175,"1,912",62,"1,850"
E01005564 : Rochdale 015E,"2,410",355,170,185,"2,055",68,"1,987"
E01005464 : Rochdale 016A,"1,969",404,211,193,"1,565",84,"1,481"
E01005465 : Rochdale 016B,"1,810",331,159,172,"1,479",116,"1,363"
E01005466 : Rochdale 016C,"2,485",587,317,270,"1,898",110,"1,788"
E01005467 : Rochdale 016D,"1,973",411,187,224,"1,562",90,"1,472"
E01005468 : Rochdale 016E,"2,164",242,86,156,"1,922",159,"1,763"
E01005476 : Rochdale 017A,"1,797",350,142,208,"1,447",112,"1,335"
E01005477 : Rochdale 017B,"1,772",383,182,201,"1,389",96,"1,293"
E01005478 : Rochdale 017C,"1,588",318,129,189,"1,270",107,"1,163"
E01005479 : Rochdale 017D,"1,976",395,173,222,"1,581",142,"1,439"
E01005480 : Rochdale 017E,"1,647",349,172,177,"1,298",100,"1,198"
E01005481 : Rochdale 017F,"1,681",405,226,179,"1,276",63,"1,213"
E01005497 : Rochdale 018A,"1,891",353,166,187,"1,538",102,"1,436"
E01005501 : Rochdale 018B,"1,783",500,263,237,"1,283",110,"1,173"
E01005502 : Rochdale 018C,"1,379",313,146,167,"1,066",90,976
E01005504 : Rochdale 018D,"1,640",345,174,171,"1,295",96,"1,199"
E01005505 : Rochdale 018E,"2,182",393,164,229,"1,789",144,"1,645"
E01005509 : Rochdale 018F,"1,445",388,198,190,"1,057",72,985
E01005510 : Rochdale 019A,"1,094",175,70,105,919,100,819
E01005511 : Rochdale 019B,"1,253",301,163,138,952,75,877
E01005512 : Rochdale 019C,"1,442",289,131,158,"1,153",106,"1,047"
E01005513 : Rochdale 019D,"1,554",348,177,171,"1,206",76,"1,130"
E01005514 : Rochdale 019E,"1,844",365,153,212,"1,479",101,"1,378"
E01005515 : Rochdale 019F,"1,798",468,233,235,"1,330",84,"1,246"
E01005498 : Rochdale 020A,"1,375",256,103,153,"1,119",94,"1,025"
E01005500 : Rochdale 020B,"1,592",349,165,184,"1,243",99,"1,144"
E01005503 : Rochdale 020C,"1,318",181,71,110,"1,137",109,"1,028"
E01005506 : Rochdale 020D,"1,545",355,177,178,"1,190",101,"1,089"
E01005507 : Rochdale 020E,"2,260",319,115,204,"1,941",163,"1,778"
E01005508 : Rochdale 020F,"2,013",274,116,158,"1,739",131,"1,608"
E01005524 : Rochdale 021A,"1,470",261,126,135,"1,209",115,"1,094"
E01005525 : Rochdale 021B,"1,886",427,224,203,"1,459",91,"1,368"
E01005526 : Rochdale 021C,"1,908",339,156,183,"1,569",102,"1,467"
E01005528 : Rochdale 021D,"1,551",335,145,190,"1,216",103,"1,113"
E01005536 : Rochdale 021E,"1,713",340,157,183,"1,373",86,"1,287"
E01005543 : Rochdale 021F,"1,252",268,112,156,984,64,920
E01005527 : Rochdale 022A,"2,059",423,237,186,"1,636",114,"1,522"
E01005529 : Rochdale 022B,"1,660",406,223,183,"1,254",91,"1,163"
E01005551 : Rochdale 022C,"2,026",458,257,201,"1,568",103,"1,465"
E01005552 : Rochdale 022D,"2,340",559,295,264,"1,781",114,"1,667"
E01005553 : Rochdale 022E,"2,037",472,243,229,"1,565",105,"1,460"
E01005554 : Rochdale 022F,"2,157",289,121,168,"1,868",102,"1,766"
E01005534 : Rochdale 023A,"1,418",267,139,128,"1,151",83,"1,068"
E01005535 : Rochdale 023B,"1,468",297,158,139,"1,171",81,"1,090"
E01005537 : Rochdale 023C,"1,270",240,109,131,"1,030",101,929
E01005538 : Rochdale 023D,"1,479",296,137,159,"1,183",62,"1,121"
E01005540 : Rochdale 023E,"1,344",245,119,126,"1,099",94,"1,005"
E01005541 : Rochdale 023F,"1,534",300,137,163,"1,234",106,"1,128"
E01005542 : Rochdale 023G,"1,616",378,202,176,"1,238",86,"1,152"
E01005533 : Rochdale 024A,"1,621",336,155,181,"1,285",127,"1,158"
E01005539 : Rochdale 024B,"1,315",328,165,163,987,72,915
E01005546 : Rochdale 024C,"1,241",258,126,132,983,81,902
E01005547 : Rochdale 024D,"1,755",310,159,151,"1,445",97,"1,348"
E01005548 : Rochdale 024E,"1,275",305,149,156,970,82,888
E01005530 : Rochdale 025A,"1,458",248,107,141,"1,210",100,"1,110"
E01005531 : Rochdale 025B,"1,158",212,101,111,946,94,852
E01005532 : Rochdale 025C,"1,548",313,158,155,"1,235",63,"1,172"
E01005544 : Rochdale 025D,"1,475",204,89,115,"1,271",99,"1,172"
E01005545 : Rochdale 025E,"1,250",195,70,125,"1,055",94,961
E01005549 : Rochdale 025F,"1,548",234,93,141,"1,314",104,"1,210"
E01005550 : Rochdale 025G,"1,463",266,101,165,"1,197",109,"1,088"
E01005659 : Salford 001A,"1,542",388,214,174,"1,154",86,"1,068"
E01005660 : Salford 001B,"1,823",479,246,233,"1,344",83,"1,261"
E01005663 : Salford 001C,"1,525",291,140,151,"1,234",79,"1,155"
E01005664 : Salford 001D,"1,709",377,201,176,"1,332",65,"1,267"
E01005665 : Salford 001E,"2,104",567,275,292,"1,537",88,"1,449"
E01005703 : Salford 002A,"1,746",458,234,224,"1,288",85,"1,203"
E01005704 : Salford 002B,"1,344",308,157,151,"1,036",77,959
E01005706 : Salford 002C,"1,536",403,213,190,"1,133",75,"1,058"
E01005708 : Salford 002D,"1,434",355,161,194,"1,079",92,987
E01005702 : Salford 003A,"2,638",483,237,246,"2,155",172,"1,983"
E01005707 : Salford 003C,"1,751",426,211,215,"1,325",88,"1,237"
E01033976 : Salford 003D,"1,965",199,70,129,"1,766",150,"1,616"
E01033977 : Salford 003E,"1,141",257,136,121,884,88,796
E01005661 : Salford 004A,"1,900",419,207,212,"1,481",104,"1,377"
E01005662 : Salford 004B,"1,622",424,221,203,"1,198",62,"1,136"
E01005709 : Salford 004C,"1,606",438,249,189,"1,168",75,"1,093"
E01005710 : Salford 004D,"2,143",362,162,200,"1,781",155,"1,626"
E01005670 : Salford 005A,"1,758",398,197,201,"1,360",119,"1,241"
E01005672 : Salford 005B,"1,278",232,105,127,"1,046",65,981
E01005676 : Salford 005C,"1,225",240,115,125,985,82,903
E01005677 : Salford 005D,"1,582",302,147,155,"1,280",110,"1,170"
E01005686 : Salford 006A,"1,463",296,127,169,"1,167",93,"1,074"
E01005688 : Salford 006B,"1,569",297,141,156,"1,272",112,"1,160"
E01005691 : Salford 006C,"1,414",284,131,153,"1,130",120,"1,010"
E01005692 : Salford 006D,"1,375",382,212,170,993,74,919
E01005711 : Salford 007A,"1,394",260,115,145,"1,134",97,"1,037"
E01005712 : Salford 007B,"1,837",317,139,178,"1,520",136,"1,384"
E01005713 : Salford 007C,"1,625",248,100,148,"1,377",130,"1,247"
E01005714 : Salford 007D,"1,709",326,171,155,"1,383",114,"1,269"
E01005715 : Salford 007E,"1,746",289,110,179,"1,457",129,"1,328"
E01005718 : Salford 007F,"1,604",337,151,186,"1,267",120,"1,147"
E01005673 : Salford 008A,"1,486",252,120,132,"1,234",95,"1,139"
E01005678 : Salford 008C,"1,570",345,179,166,"1,225",81,"1,144"
E01005679 : Salford 008D,"1,550",323,171,152,"1,227",83,"1,144"
E01033978 : Salford 008E,"1,024",117,43,74,907,69,838
E01033979 : Salford 008F,"2,043",559,268,291,"1,484",150,"1,334"
E01005687 : Salford 009A,"1,804",316,128,188,"1,488",143,"1,345"
E01005689 : Salford 009B,"1,366",263,136,127,"1,103",86,"1,017"
E01005690 : Salford 009C,"1,568",319,146,173,"1,249",116,"1,133"
E01005693 : Salford 009D,"1,433",242,95,147,"1,191",125,"1,066"
E01005646 : Salford 010A,"2,252",232,95,137,"2,020",99,"1,921"
E01005649 : Salford 010B,"1,724",221,100,121,"1,503",82,"1,421"
E01005650 : Salford 010C,"1,991",274,109,165,"1,717",69,"1,648"
E01005651 : Salford 010D,"2,277",228,119,109,"2,049",68,"1,981"
E01005647 : Salford 011A,"1,502",268,118,150,"1,234",96,"1,138"
E01005648 : Salford 011B,"2,351",326,134,192,"2,025",131,"1,894"
E01005652 : Salford 011C,"1,555",311,165,146,"1,244",69,"1,175"
E01005653 : Salford 011D,"1,562",298,162,136,"1,264",67,"1,197"
E01005671 : Salford 012A,"1,567",337,162,175,"1,230",89,"1,141"
E01005674 : Salford 012B,"1,573",393,218,175,"1,180",88,"1,092"
E01005694 : Salford 012C,"1,709",270,114,156,"1,439",108,"1,331"
E01005696 : Salford 012D,"1,785",300,118,182,"1,485",105,"1,380"
E01005698 : Salford 012E,"1,743",444,222,222,"1,299",90,"1,209"
E01005700 : Salford 012F,"1,516",310,135,175,"1,206",103,"1,103"
E01005716 : Salford 013A,"1,632",219,77,142,"1,413",126,"1,287"
E01005717 : Salford 013B,"1,556",137,41,96,"1,419",110,"1,309"
E01005734 : Salford 013C,"1,419",310,172,138,"1,109",97,"1,012"
E01005735 : Salford 013D,"1,423",209,91,118,"1,214",96,"1,118"
E01005736 : Salford 013E,"1,368",214,91,123,"1,154",92,"1,062"
E01005737 : Salford 013F,"1,511",207,75,132,"1,304",104,"1,200"
E01005739 : Salford 013G,"1,999",219,82,137,"1,780",136,"1,644"
E01005695 : Salford 014A,"1,559",197,66,131,"1,362",102,"1,260"
E01005697 : Salford 014B,"1,531",215,80,135,"1,316",108,"1,208"
E01005738 : Salford 014C,"1,931",253,104,149,"1,678",144,"1,534"
E01005740 : Salford 014D,"1,599",239,113,126,"1,360",122,"1,238"
E01005741 : Salford 014E,"1,679",184,69,115,"1,495",129,"1,366"
E01005742 : Salford 014F,"1,554",225,81,144,"1,329",115,"1,214"
E01005625 : Salford 015A,"1,373",212,93,119,"1,161",96,"1,065"
E01005627 : Salford 015B,"1,172",197,78,119,975,75,900
E01005699 : Salford 015C,"1,792",294,107,187,"1,498",98,"1,400"
E01005701 : Salford 015D,"1,826",371,156,215,"1,455",123,"1,332"
E01005624 : Salford 017A,"1,842",354,169,185,"1,488",90,"1,398"
E01005680 : Salford 017B,"1,732",497,260,237,"1,235",87,"1,148"
E01005683 : Salford 017C,"2,149",483,253,230,"1,666",103,"1,563"
E01033980 : Salford 017G,"1,043",160,65,95,883,47,836
E01033981 : Salford 017H,"2,739",510,209,301,"2,229",188,"2,041"
E01005622 : Salford 018A,"1,595",298,125,173,"1,297",136,"1,161"
E01005623 : Salford 018B,"1,266",194,89,105,"1,072",101,971
E01005626 : Salford 018C,"1,286",205,96,109,"1,081",98,983
E01005628 : Salford 018D,"1,575",335,152,183,"1,240",109,"1,131"
E01005725 : Salford 019A,"1,460",343,173,170,"1,117",83,"1,034"
E01005726 : Salford 019B,"1,431",271,127,144,"1,160",112,"1,048"
E01005727 : Salford 019C,"1,349",235,98,137,"1,114",121,993
E01005728 : Salford 019D,"1,791",258,110,148,"1,533",128,"1,405"
E01005733 : Salford 019E,"1,468",294,162,132,"1,174",69,"1,105"
E01005631 : Salford 020A,"1,577",504,268,236,"1,073",104,969
E01005632 : Salford 020B,"2,452",423,176,247,"2,029",146,"1,883"
E01005633 : Salford 020C,"1,532",350,191,159,"1,182",80,"1,102"
E01005634 : Salford 020D,"1,589",224,76,148,"1,365",113,"1,252"
E01005635 : Salford 020E,"1,552",304,156,148,"1,248",117,"1,131"
E01005636 : Salford 020F,"1,594",275,127,148,"1,319",121,"1,198"
E01005637 : Salford 020G,"1,455",259,112,147,"1,196",120,"1,076"
E01005629 : Salford 021A,"1,485",267,132,135,"1,218",125,"1,093"
E01005630 : Salford 021B,"1,529",269,120,149,"1,260",111,"1,149"
E01005719 : Salford 021C,"2,035",444,220,224,"1,591",143,"1,448"
E01005722 : Salford 021E,"2,032",442,234,208,"1,590",117,"1,473"
E01005723 : Salford 021F,"1,661",344,176,168,"1,317",78,"1,239"
E01005724 : Salford 021G,"1,414",247,128,119,"1,167",102,"1,065"
E01033982 : Salford 021H,"1,911",401,205,196,"1,510",106,"1,404"
E01033983 : Salford 021I,"1,275",231,84,147,"1,044",74,970
E01005654 : Salford 023A,"1,966",296,120,176,"1,670",137,"1,533"
E01005656 : Salford 023B,"1,697",294,129,165,"1,403",101,"1,302"
E01005657 : Salford 023C,"1,802",384,169,215,"1,418",119,"1,299"
E01005721 : Salford 023D,"1,552",405,198,207,"1,147",87,"1,060"
E01005681 : Salford 024C,"1,504",352,173,179,"1,152",92,"1,060"
E01005682 : Salford 024D,"1,741",504,272,232,"1,237",78,"1,159"
E01033984 : Salford 024E,"2,444",454,239,215,"1,990",101,"1,889"
E01005729 : Salford 025A,"1,535",417,206,211,"1,118",94,"1,024"
E01005730 : Salford 025B,"1,668",299,118,181,"1,369",112,"1,257"
E01005731 : Salford 025C,"1,566",359,182,177,"1,207",68,"1,139"
E01005732 : Salford 025D,"1,207",305,149,156,902,73,829
E01005599 : Salford 026A,"1,902",391,194,197,"1,511",112,"1,399"
E01005600 : Salford 026B,"2,036",353,156,197,"1,683",125,"1,558"
E01005601 : Salford 026C,"1,740",416,231,185,"1,324",103,"1,221"
E01005602 : Salford 026D,"1,674",412,188,224,"1,262",111,"1,151"
E01005603 : Salford 027A,"1,809",303,128,175,"1,506",117,"1,389"
E01005604 : Salford 027B,"1,651",350,153,197,"1,301",110,"1,191"
E01005605 : Salford 027C,"1,658",301,122,179,"1,357",106,"1,251"
E01005638 : Salford 027D,"2,212",541,242,299,"1,671",129,"1,542"
E01005639 : Salford 029A,"1,517",400,199,201,"1,117",83,"1,034"
E01005640 : Salford 029B,"1,358",327,160,167,"1,031",70,961
E01005641 : Salford 029C,"1,368",354,196,158,"1,014",95,919
E01005642 : Salford 029D,"1,209",184,85,99,"1,025",98,927
E01005643 : Salford 029E,"1,369",291,123,168,"1,078",94,984
E01005644 : Salford 029F,"1,515",205,84,121,"1,310",88,"1,222"
E01005645 : Salford 029G,"1,361",261,111,150,"1,100",112,988
E01005616 : Salford 030A,"1,446",315,153,162,"1,131",87,"1,044"
E01005617 : Salford 030B,"1,481",274,120,154,"1,207",113,"1,094"
E01005618 : Salford 030C,"2,080",385,183,202,"1,695",146,"1,549"
E01005619 : Salford 030D,"1,231",263,129,134,968,97,871
E01005620 : Salford 030E,"2,549",339,131,208,"2,210",192,"2,018"
E01005621 : Salford 030F,"1,770",421,193,228,"1,349",113,"1,236"
E01005613 : Salford 031A,"2,698",451,255,196,"2,247",67,"2,180"
E01005612 : Salford 031B,"2,481",490,278,212,"1,991",90,"1,901"
E01005614 : Salford 031C,"3,100",269,123,146,"2,831",72,"2,759"
E01033985 : Salford 032A,"1,664",338,201,137,"1,326",53,"1,273"
E01033986 : Salford 032B,"1,524",189,77,112,"1,335",78,"1,257"
E01005611 : Salford 032C,"2,513",458,214,244,"2,055",149,"1,906"
E01005615 : Salford 032D,"2,370",367,233,134,"2,003",63,"1,940"
E01033987 : Salford 033A,"1,137",96,21,75,"1,041",81,960
E01033988 : Salford 033B,"1,312",122,19,103,"1,190",114,"1,076"
E01033989 : Salford 033C,"1,134",156,53,103,978,118,860
E01033990 : Salford 033D,"1,187",121,24,97,"1,066",94,972
E01033330 : Salford 033E,"1,540",400,181,219,"1,140",73,"1,067"
E01032909 : Salford 033F,"1,716",133,27,106,"1,583",143,"1,440"
E01033991 : Salford 034A,"1,564",292,123,169,"1,272",111,"1,161"
E01033992 : Salford 034B,"1,398",127,17,110,"1,271",109,"1,162"
E01005610 : Salford 034C,"2,939",549,196,353,"2,390",148,"2,242"
E01032684 : Salford 034D,"1,386",229,103,126,"1,157",96,"1,061"
E01032906 : Salford 034E,"2,042",289,123,166,"1,753",142,"1,611"
E01032914 : Salford 035A,"2,123",270,71,199,"1,853",192,"1,661"
E01032912 : Salford 035B,"2,270",441,249,192,"1,829",101,"1,728"
E01005667 : Salford 035C,"2,275",463,254,209,"1,812",126,"1,686"
E01033993 : Salford 036A,"1,814",224,85,139,"1,590",141,"1,449"
E01033994 : Salford 036B,"1,172",88,17,71,"1,084",107,977
E01032915 : Salford 036C,"2,139",363,164,199,"1,776",137,"1,639"
E01033995 : Salford 037A,"1,204",121,30,91,"1,083",78,"1,005"
E01033996 : Salford 037B,"1,215",121,23,98,"1,094",121,973
E01033997 : Salford 037C,"1,030",122,27,95,908,77,831
E01033998 : Salford 037D,"1,330",157,38,119,"1,173",94,"1,079"
E01033999 : Salford 037E,"1,223",104,23,81,"1,119",106,"1,013"
E01005886 : Stockport 001A,"1,466",278,130,148,"1,188",104,"1,084"
E01005888 : Stockport 001B,"1,530",296,147,149,"1,234",99,"1,135"
E01005889 : Stockport 001C,"1,424",342,172,170,"1,082",89,993
E01005891 : Stockport 001D,"1,221",236,99,137,985,70,915
E01005894 : Stockport 001E,"1,361",207,83,124,"1,154",113,"1,041"
E01005887 : Stockport 002A,"1,732",325,123,202,"1,407",97,"1,310"
E01005890 : Stockport 002B,"1,528",305,132,173,"1,223",87,"1,136"
E01005893 : Stockport 002C,"2,188",374,145,229,"1,814",146,"1,668"
E01005896 : Stockport 002D,"1,664",298,113,185,"1,366",120,"1,246"
E01005919 : Stockport 002E,"1,541",352,168,184,"1,189",90,"1,099"
E01005862 : Stockport 003A,"1,476",200,78,122,"1,276",134,"1,142"
E01005892 : Stockport 003B,"1,269",258,116,142,"1,011",79,932
E01005895 : Stockport 003C,"1,167",216,107,109,951,82,869
E01005920 : Stockport 003D,"1,601",239,92,147,"1,362",93,"1,269"
E01005921 : Stockport 003E,"1,471",326,139,187,"1,145",110,"1,035"
E01005922 : Stockport 003F,"1,316",238,118,120,"1,078",111,967
E01005753 : Stockport 004A,"1,838",527,312,215,"1,311",102,"1,209"
E01005754 : Stockport 004B,"2,005",681,376,305,"1,324",120,"1,204"
E01005755 : Stockport 004C,"1,737",423,219,204,"1,314",85,"1,229"
E01005756 : Stockport 004D,"2,375",613,288,325,"1,762",114,"1,648"
E01005745 : Stockport 005A,"1,375",234,92,142,"1,141",123,"1,018"
E01005746 : Stockport 005B,"1,452",475,263,212,977,99,878
E01005747 : Stockport 005C,"1,403",216,79,137,"1,187",105,"1,082"
E01005748 : Stockport 005D,"1,511",238,96,142,"1,273",141,"1,132"
E01005863 : Stockport 006A,"1,719",261,94,167,"1,458",138,"1,320"
E01005864 : Stockport 006B,"1,576",234,120,114,"1,342",135,"1,207"
E01005866 : Stockport 006C,"1,669",267,99,168,"1,402",117,"1,285"
E01005869 : Stockport 006D,"1,593",317,140,177,"1,276",128,"1,148"
E01005914 : Stockport 007A,"1,418",264,125,139,"1,154",102,"1,052"
E01005915 : Stockport 007B,"1,549",337,144,193,"1,212",109,"1,103"
E01005916 : Stockport 007C,"1,614",318,125,193,"1,296",108,"1,188"
E01005917 : Stockport 007D,"1,826",381,160,221,"1,445",134,"1,311"
E01005859 : Stockport 008A,"1,411",203,76,127,"1,208",138,"1,070"
E01005865 : Stockport 008B,"1,963",244,91,153,"1,719",133,"1,586"
E01005867 : Stockport 008C,"1,483",245,92,153,"1,238",127,"1,111"
E01005868 : Stockport 008D,"1,522",232,79,153,"1,290",119,"1,171"
E01005743 : Stockport 009A,"1,274",220,99,121,"1,054",104,950
E01005744 : Stockport 009B,"1,554",421,225,196,"1,133",90,"1,043"
E01005749 : Stockport 009C,"1,655",300,118,182,"1,355",120,"1,235"
E01005750 : Stockport 009D,"1,667",257,91,166,"1,410",134,"1,276"
E01005751 : Stockport 009E,"1,401",241,103,138,"1,160",117,"1,043"
E01005897 : Stockport 010A,"1,528",377,180,197,"1,151",112,"1,039"
E01005898 : Stockport 010B,"1,708",340,155,185,"1,368",167,"1,201"
E01005900 : Stockport 010C,"1,608",355,151,204,"1,253",126,"1,127"
E01005903 : Stockport 010D,"1,457",206,73,133,"1,251",148,"1,103"
E01005904 : Stockport 010E,"1,530",256,84,172,"1,274",135,"1,139"
E01005853 : Stockport 011A,"1,613",305,146,159,"1,308",122,"1,186"
E01005856 : Stockport 011B,"1,602",212,81,131,"1,390",127,"1,263"
E01005860 : Stockport 011C,"1,518",178,52,126,"1,340",115,"1,225"
E01005861 : Stockport 011D,"1,543",243,88,155,"1,300",129,"1,171"
E01005752 : Stockport 012A,"1,405",316,159,157,"1,089",104,985
E01005899 : Stockport 012B,"1,619",409,175,234,"1,210",121,"1,089"
E01005901 : Stockport 012C,"1,366",303,128,175,"1,063",132,931
E01005902 : Stockport 012D,"1,621",399,204,195,"1,222",107,"1,115"
E01005905 : Stockport 012E,"1,511",358,170,188,"1,153",103,"1,050"
E01005852 : Stockport 013A,"1,484",238,84,154,"1,246",120,"1,126"
E01005854 : Stockport 013B,"1,729",213,68,145,"1,516",172,"1,344"
E01005855 : Stockport 013C,"1,483",172,73,99,"1,311",138,"1,173"
E01005857 : Stockport 013D,"1,627",261,106,155,"1,366",120,"1,246"
E01005858 : Stockport 013E,"1,580",239,71,168,"1,341",152,"1,189"
E01005757 : Stockport 014A,"1,604",315,140,175,"1,289",107,"1,182"
E01005766 : Stockport 014C,"1,781",412,186,226,"1,369",102,"1,267"
E01005918 : Stockport 014D,"1,616",569,342,227,"1,047",75,972
E01033947 : Stockport 014E,"1,540",357,153,204,"1,183",121,"1,062"
E01033948 : Stockport 014F,"1,348",413,196,217,935,91,844
E01005870 : Stockport 015A,"1,374",244,96,148,"1,130",98,"1,032"
E01005871 : Stockport 015B,"1,382",265,101,164,"1,117",118,999
E01005873 : Stockport 015C,"1,468",261,100,161,"1,207",128,"1,079"
E01005875 : Stockport 015D,"1,562",216,76,140,"1,346",100,"1,246"
E01005764 : Stockport 016A,"1,607",316,136,180,"1,291",129,"1,162"
E01005816 : Stockport 016B,"1,562",241,92,149,"1,321",124,"1,197"
E01005817 : Stockport 016C,"1,391",233,93,140,"1,158",107,"1,051"
E01005822 : Stockport 016D,"1,900",442,215,227,"1,458",121,"1,337"
E01005880 : Stockport 017A,"1,486",227,82,145,"1,259",133,"1,126"
E01005881 : Stockport 017B,"1,210",173,53,120,"1,037",136,901
E01005883 : Stockport 017C,"1,519",235,78,157,"1,284",177,"1,107"
E01005908 : Stockport 017D,"1,643",159,52,107,"1,484",139,"1,345"
E01005765 : Stockport 018A,"1,379",222,80,142,"1,157",125,"1,032"
E01005818 : Stockport 018B,"1,401",233,107,126,"1,168",94,"1,074"
E01005819 : Stockport 018C,"1,595",233,84,149,"1,362",122,"1,240"
E01005820 : Stockport 018D,"1,493",293,133,160,"1,200",117,"1,083"
E01005821 : Stockport 018E,"1,411",274,105,169,"1,137",113,"1,024"
E01005823 : Stockport 018F,"1,646",341,142,199,"1,305",138,"1,167"
E01005825 : Stockport 019A,"1,676",288,116,172,"1,388",136,"1,252"
E01005872 : Stockport 019B,"1,646",361,156,205,"1,285",134,"1,151"
E01005874 : Stockport 019C,"1,875",525,234,291,"1,350",141,"1,209"
E01005876 : Stockport 019D,"1,495",252,87,165,"1,243",124,"1,119"
E01005877 : Stockport 019E,"1,737",338,133,205,"1,399",128,"1,271"
E01005878 : Stockport 020A,"1,748",376,173,203,"1,372",135,"1,237"
E01005879 : Stockport 020B,"1,316",260,115,145,"1,056",121,935
E01005882 : Stockport 020C,"1,276",169,81,88,"1,107",124,983
E01005884 : Stockport 020D,"1,433",206,74,132,"1,227",138,"1,089"
E01005885 : Stockport 020E,"1,494",293,133,160,"1,201",156,"1,045"
E01005832 : Stockport 021A,"1,421",262,102,160,"1,159",103,"1,056"
E01005833 : Stockport 021B,"1,039",257,125,132,782,75,707
E01005835 : Stockport 021C,"1,392",208,68,140,"1,184",124,"1,060"
E01005837 : Stockport 021D,"1,545",236,88,148,"1,309",112,"1,197"
E01005843 : Stockport 021E,"1,450",218,87,131,"1,232",119,"1,113"
E01005769 : Stockport 022A,"1,552",294,144,150,"1,258",123,"1,135"
E01005778 : Stockport 022B,"1,406",246,107,139,"1,160",107,"1,053"
E01005779 : Stockport 022C,"1,473",252,98,154,"1,221",99,"1,122"
E01005780 : Stockport 022D,"1,482",230,93,137,"1,252",124,"1,128"
E01005781 : Stockport 022E,"1,654",456,214,242,"1,198",126,"1,072"
E01005759 : Stockport 023A,"1,677",285,109,176,"1,392",152,"1,240"
E01005760 : Stockport 023B,"1,935",344,141,203,"1,591",139,"1,452"
E01005797 : Stockport 023C,"1,414",273,100,173,"1,141",99,"1,042"
E01005800 : Stockport 023D,"1,620",268,97,171,"1,352",119,"1,233"
E01005804 : Stockport 023E,"1,131",274,134,140,857,87,770
E01005824 : Stockport 024A,"1,509",281,103,178,"1,228",98,"1,130"
E01005826 : Stockport 024B,"1,611",458,227,231,"1,153",80,"1,073"
E01005827 : Stockport 024C,"1,752",308,132,176,"1,444",149,"1,295"
E01005828 : Stockport 024D,"1,375",407,234,173,968,64,904
E01005829 : Stockport 024E,"1,192",270,112,158,922,91,831
E01005768 : Stockport 025A,"2,066",279,112,167,"1,787",150,"1,637"
E01005770 : Stockport 025B,"1,496",259,108,151,"1,237",124,"1,113"
E01005771 : Stockport 025C,"1,436",227,105,122,"1,209",99,"1,110"
E01005775 : Stockport 025D,"1,664",247,102,145,"1,417",117,"1,300"
E01005761 : Stockport 026A,"1,409",293,147,146,"1,116",89,"1,027"
E01005762 : Stockport 026B,"1,973",478,236,242,"1,495",97,"1,398"
E01005763 : Stockport 026C,"1,733",426,210,216,"1,307",99,"1,208"
E01005799 : Stockport 026D,"1,874",412,191,221,"1,462",110,"1,352"
E01005798 : Stockport 027A,"1,639",400,192,208,"1,239",138,"1,101"
E01005801 : Stockport 027B,"2,219",334,136,198,"1,885",170,"1,715"
E01005802 : Stockport 027C,"1,482",206,74,132,"1,276",121,"1,155"
E01005803 : Stockport 027D,"1,394",194,64,130,"1,200",126,"1,074"
E01005830 : Stockport 027E,"1,540",268,104,164,"1,272",151,"1,121"
E01005831 : Stockport 027F,"1,642",259,81,178,"1,383",147,"1,236"
E01005767 : Stockport 028A,"1,633",279,127,152,"1,354",106,"1,248"
E01005772 : Stockport 028B,"1,551",249,110,139,"1,302",118,"1,184"
E01005773 : Stockport 028C,"1,575",270,117,153,"1,305",109,"1,196"
E01005774 : Stockport 028D,"1,549",411,201,210,"1,138",107,"1,031"
E01005776 : Stockport 028E,"1,714",223,88,135,"1,491",96,"1,395"
E01005909 : Stockport 029A,"1,531",255,97,158,"1,276",139,"1,137"
E01005910 : Stockport 029B,"1,614",341,167,174,"1,273",119,"1,154"
E01005911 : Stockport 029C,"1,330",311,147,164,"1,019",115,904
E01005912 : Stockport 029D,"1,496",219,73,146,"1,277",132,"1,145"
E01005782 : Stockport 030A,"1,277",217,88,129,"1,060",111,949
E01005783 : Stockport 030B,"1,549",285,108,177,"1,264",122,"1,142"
E01005784 : Stockport 030C,"1,491",207,86,121,"1,284",112,"1,172"
E01005785 : Stockport 030D,"1,673",220,74,146,"1,453",147,"1,306"
E01005786 : Stockport 030E,"1,846",247,77,170,"1,599",139,"1,460"
E01005834 : Stockport 031A,"1,543",294,132,162,"1,249",114,"1,135"
E01005836 : Stockport 031B,"1,833",376,146,230,"1,457",164,"1,293"
E01005838 : Stockport 031C,"1,782",296,97,199,"1,486",136,"1,350"
E01005840 : Stockport 031D,"1,603",283,111,172,"1,320",120,"1,200"
E01005927 : Stockport 032A,"1,305",179,59,120,"1,126",124,"1,002"
E01005928 : Stockport 032B,"1,619",334,141,193,"1,285",135,"1,150"
E01005929 : Stockport 032C,"1,420",195,74,121,"1,225",122,"1,103"
E01005930 : Stockport 032D,"1,678",256,103,153,"1,422",142,"1,280"
E01005806 : Stockport 033A,"1,187",185,64,121,"1,002",95,907
E01005813 : Stockport 033B,"1,365",210,67,143,"1,155",114,"1,041"
E01005814 : Stockport 033C,"1,298",184,86,98,"1,114",106,"1,008"
E01005815 : Stockport 033D,"1,436",166,50,116,"1,270",119,"1,151"
E01005777 : Stockport 034A,"1,558",321,144,177,"1,237",115,"1,122"
E01005787 : Stockport 034B,"1,333",135,38,97,"1,198",134,"1,064"
E01005788 : Stockport 034C,"1,567",201,73,128,"1,366",140,"1,226"
E01005790 : Stockport 034D,"1,220",230,103,127,990,99,891
E01005805 : Stockport 035A,"1,540",238,91,147,"1,302",157,"1,145"
E01005807 : Stockport 035B,"1,550",225,84,141,"1,325",123,"1,202"
E01005839 : Stockport 035C,"1,295",180,66,114,"1,115",124,991
E01005841 : Stockport 035D,"1,480",252,124,128,"1,228",144,"1,084"
E01005844 : Stockport 036A,"1,548",290,140,150,"1,258",97,"1,161"
E01005845 : Stockport 036B,"1,657",283,118,165,"1,374",111,"1,263"
E01005849 : Stockport 036C,"1,652",267,104,163,"1,385",120,"1,265"
E01005851 : Stockport 036D,"1,623",237,104,133,"1,386",128,"1,258"
E01005808 : Stockport 037A,"1,375",165,63,102,"1,210",124,"1,086"
E01005809 : Stockport 037B,"1,224",179,64,115,"1,045",82,963
E01005810 : Stockport 037C,"1,561",290,127,163,"1,271",119,"1,152"
E01005811 : Stockport 037D,"1,299",200,68,132,"1,099",122,977
E01005812 : Stockport 037E,"1,207",133,56,77,"1,074",102,972
E01005842 : Stockport 038A,"1,581",295,119,176,"1,286",132,"1,154"
E01005906 : Stockport 038B,"1,433",332,162,170,"1,101",108,993
E01005907 : Stockport 038C,"1,350",248,103,145,"1,102",129,973
E01005913 : Stockport 038D,"1,419",250,94,156,"1,169",138,"1,031"
E01005789 : Stockport 039A,"1,672",262,93,169,"1,410",144,"1,266"
E01005791 : Stockport 039B,"1,569",257,103,154,"1,312",134,"1,178"
E01005793 : Stockport 039C,"1,522",232,95,137,"1,290",113,"1,177"
E01005795 : Stockport 039D,"1,365",177,41,136,"1,188",110,"1,078"
E01005796 : Stockport 039E,"1,245",174,50,124,"1,071",117,954
E01005846 : Stockport 040A,"1,715",248,98,150,"1,467",131,"1,336"
E01005847 : Stockport 040B,"1,576",280,125,155,"1,296",112,"1,184"
E01005848 : Stockport 040C,"2,084",327,139,188,"1,757",128,"1,629"
E01005850 : Stockport 040D,"1,805",371,184,187,"1,434",121,"1,313"
E01005792 : Stockport 041A,"1,530",199,71,128,"1,331",117,"1,214"
E01005794 : Stockport 041B,"1,268",156,64,92,"1,112",103,"1,009"
E01005923 : Stockport 041C,"1,497",209,67,142,"1,288",124,"1,164"
E01005931 : Stockport 041D,"1,394",209,82,127,"1,185",117,"1,068"
E01005924 : Stockport 042A,"1,305",197,82,115,"1,108",98,"1,010"
E01005925 : Stockport 042B,"1,433",277,119,158,"1,156",127,"1,029"
E01005926 : Stockport 042C,"2,243",213,63,150,"2,030",183,"1,847"
E01005932 : Stockport 042D,"1,280",181,50,131,"1,099",119,980
E01006053 : Tameside 001A,"1,945",282,104,178,"1,663",166,"1,497"
E01006054 : Tameside 001B,"1,807",421,212,209,"1,386",100,"1,286"
E01006055 : Tameside 001C,"1,505",251,94,157,"1,254",132,"1,122"
E01006057 : Tameside 001D,"1,531",255,98,157,"1,276",127,"1,149"
E01006058 : Tameside 001E,"2,074",394,175,219,"1,680",188,"1,492"
E01006059 : Tameside 001F,"1,443",233,88,145,"1,210",137,"1,073"
E01005938 : Tameside 002A,"1,568",313,163,150,"1,255",92,"1,163"
E01005939 : Tameside 002B,"1,271",202,89,113,"1,069",65,"1,004"
E01005940 : Tameside 002C,"1,400",274,131,143,"1,126",91,"1,035"
E01005955 : Tameside 002D,"1,634",240,105,135,"1,394",101,"1,293"
E01006056 : Tameside 003A,"1,250",303,140,163,947,58,889
E01006061 : Tameside 003B,"2,479",459,231,228,"2,020",158,"1,862"
E01006062 : Tameside 003C,"1,989",301,105,196,"1,688",171,"1,517"
E01006063 : Tameside 003D,"1,383",238,85,153,"1,145",102,"1,043"
E01005936 : Tameside 004A,"1,517",262,120,142,"1,255",119,"1,136"
E01005937 : Tameside 004B,"1,707",302,129,173,"1,405",103,"1,302"
E01005945 : Tameside 004C,"2,043",426,210,216,"1,617",104,"1,513"
E01005946 : Tameside 004D,"1,585",297,123,174,"1,288",87,"1,201"
E01005947 : Tameside 004E,"1,839",365,174,191,"1,474",75,"1,399"
E01005954 : Tameside 005A,"1,496",433,239,194,"1,063",91,972
E01005956 : Tameside 005B,"1,375",316,139,177,"1,059",93,966
E01005957 : Tameside 005C,"1,561",270,117,153,"1,291",98,"1,193"
E01005958 : Tameside 005D,"1,607",409,222,187,"1,198",108,"1,090"
E01005959 : Tameside 005E,"1,952",393,202,191,"1,559",107,"1,452"
E01005933 : Tameside 006A,"1,574",317,166,151,"1,257",76,"1,181"
E01005934 : Tameside 006B,"1,507",294,119,175,"1,213",104,"1,109"
E01005935 : Tameside 006C,"1,463",373,205,168,"1,090",78,"1,012"
E01005949 : Tameside 006D,"1,652",323,159,164,"1,329",92,"1,237"
E01005960 : Tameside 006E,"1,748",380,187,193,"1,368",132,"1,236"
E01005941 : Tameside 007A,"1,884",432,205,227,"1,452",84,"1,368"
E01005942 : Tameside 007B,"1,661",281,116,165,"1,380",136,"1,244"
E01005943 : Tameside 007C,"1,815",369,161,208,"1,446",127,"1,319"
E01005944 : Tameside 007D,"1,853",249,107,142,"1,604",124,"1,480"
E01006060 : Tameside 008A,"1,510",353,149,204,"1,157",95,"1,062"
E01006064 : Tameside 008B,"1,728",490,231,259,"1,238",108,"1,130"
E01006065 : Tameside 008C,"1,460",296,130,166,"1,164",78,"1,086"
E01006066 : Tameside 008D,"1,418",338,171,167,"1,080",123,957
E01006067 : Tameside 009A,"1,875",238,75,163,"1,637",147,"1,490"
E01006068 : Tameside 009B,"1,559",406,193,213,"1,153",104,"1,049"
E01006069 : Tameside 009C,"1,740",353,161,192,"1,387",97,"1,290"
E01006073 : Tameside 009D,"2,044",377,176,201,"1,667",131,"1,536"
E01005993 : Tameside 010A,"1,347",261,105,156,"1,086",92,994
E01005995 : Tameside 010B,"1,371",208,80,128,"1,163",70,"1,093"
E01005996 : Tameside 010C,"1,948",330,126,204,"1,618",96,"1,522"
E01005997 : Tameside 010D,"1,536",325,146,179,"1,211",99,"1,112"
E01006000 : Tameside 010E,"1,787",445,218,227,"1,342",119,"1,223"
E01005994 : Tameside 011A,"1,507",314,152,162,"1,193",95,"1,098"
E01005999 : Tameside 011B,"2,190",416,189,227,"1,774",137,"1,637"
E01006002 : Tameside 011C,"1,370",291,146,145,"1,079",82,997
E01006004 : Tameside 011D,"1,523",265,105,160,"1,258",104,"1,154"
E01006005 : Tameside 011E,"1,393",362,207,155,"1,031",75,956
E01006007 : Tameside 011F,"1,553",306,133,173,"1,247",79,"1,168"
E01005998 : Tameside 012A,"1,881",346,148,198,"1,535",101,"1,434"
E01006001 : Tameside 012B,"1,546",295,122,173,"1,251",93,"1,158"
E01006003 : Tameside 012C,"1,530",321,147,174,"1,209",102,"1,107"
E01006006 : Tameside 012D,"1,426",284,131,153,"1,142",92,"1,050"
E01005948 : Tameside 013A,"2,315",566,246,320,"1,749",110,"1,639"
E01005950 : Tameside 013B,"2,173",318,158,160,"1,855",69,"1,786"
E01005951 : Tameside 013C,"1,856",326,135,191,"1,530",99,"1,431"
E01005953 : Tameside 013E,"2,296",472,262,210,"1,824",96,"1,728"
E01033949 : Tameside 013F,"1,190",327,177,150,863,36,827
E01033950 : Tameside 013G,"1,371",355,177,178,"1,016",78,938
E01005961 : Tameside 014A,"2,962",375,168,207,"2,587",148,"2,439"
E01005962 : Tameside 014B,"1,419",237,107,130,"1,182",99,"1,083"
E01005968 : Tameside 014C,"1,375",244,113,131,"1,131",95,"1,036"
E01005969 : Tameside 014D,"1,299",211,97,114,"1,088",96,992
E01006022 : Tameside 015A,"1,936",405,168,237,"1,531",163,"1,368"
E01006023 : Tameside 015B,"1,577",450,239,211,"1,127",104,"1,023"
E01006070 : Tameside 015C,"1,399",218,90,128,"1,181",107,"1,074"
E01006071 : Tameside 015D,"1,710",269,98,171,"1,441",121,"1,320"
E01006072 : Tameside 015E,"1,615",203,66,137,"1,412",112,"1,300"
E01006009 : Tameside 016A,"1,329",245,111,134,"1,084",105,979
E01006017 : Tameside 016B,"1,398",206,76,130,"1,192",105,"1,087"
E01006018 : Tameside 016C,"1,316",248,125,123,"1,068",91,977
E01006021 : Tameside 016D,"1,366",240,94,146,"1,126",113,"1,013"
E01006008 : Tameside 017A,"1,385",282,117,165,"1,103",119,984
E01006010 : Tameside 017B,"1,402",388,196,192,"1,014",84,930
E01006012 : Tameside 017C,"1,961",367,189,178,"1,594",136,"1,458"
E01006015 : Tameside 017D,"1,347",187,73,114,"1,160",106,"1,054"
E01006016 : Tameside 017E,"1,943",528,235,293,"1,415",115,"1,300"
E01006011 : Tameside 018A,"1,708",453,238,215,"1,255",88,"1,167"
E01006013 : Tameside 018B,"1,307",243,113,130,"1,064",94,970
E01006014 : Tameside 018C,"1,283",226,95,131,"1,057",84,973
E01006019 : Tameside 018D,"1,503",491,255,236,"1,012",99,913
E01006020 : Tameside 018E,"1,638",405,161,244,"1,233",89,"1,144"
E01005963 : Tameside 019A,"1,161",198,82,116,963,85,878
E01005964 : Tameside 019B,"1,524",274,117,157,"1,250",111,"1,139"
E01005965 : Tameside 019C,"1,733",371,214,157,"1,362",101,"1,261"
E01005966 : Tameside 019D,"1,580",256,133,123,"1,324",115,"1,209"
E01005967 : Tameside 019E,"1,424",372,177,195,"1,052",74,978
E01006031 : Tameside 020A,"2,255",418,189,229,"1,837",151,"1,686"
E01006032 : Tameside 020B,"1,528",315,154,161,"1,213",86,"1,127"
E01006033 : Tameside 020C,"1,768",357,166,191,"1,411",130,"1,281"
E01006034 : Tameside 020D,"2,133",427,194,233,"1,706",150,"1,556"
E01006035 : Tameside 020E,"2,147",437,195,242,"1,710",140,"1,570"
E01006036 : Tameside 020F,"2,153",463,219,244,"1,690",118,"1,572"
E01005970 : Tameside 021A,"1,413",287,111,176,"1,126",93,"1,033"
E01005972 : Tameside 021B,"1,720",338,142,196,"1,382",127,"1,255"
E01005974 : Tameside 021C,"1,689",377,159,218,"1,312",112,"1,200"
E01005975 : Tameside 021D,"1,544",316,130,186,"1,228",105,"1,123"
E01006024 : Tameside 022A,"1,764",242,87,155,"1,522",145,"1,377"
E01006026 : Tameside 022B,"1,527",325,144,181,"1,202",126,"1,076"
E01006037 : Tameside 022C,"1,601",230,92,138,"1,371",132,"1,239"
E01006038 : Tameside 022D,"1,588",315,133,182,"1,273",110,"1,163"
E01006047 : Tameside 023A,"1,326",255,98,157,"1,071",105,966
E01006048 : Tameside 023B,"1,596",344,141,203,"1,252",134,"1,118"
E01006049 : Tameside 023C,"1,545",322,128,194,"1,223",144,"1,079"
E01006051 : Tameside 023D,"1,628",290,113,177,"1,338",143,"1,195"
E01005985 : Tameside 024A,"1,556",266,134,132,"1,290",116,"1,174"
E01005987 : Tameside 024B,"1,518",275,132,143,"1,243",88,"1,155"
E01005988 : Tameside 024C,"1,599",236,76,160,"1,363",103,"1,260"
E01005990 : Tameside 024D,"1,374",261,97,164,"1,113",123,990
E01005991 : Tameside 024E,"1,496",250,110,140,"1,246",105,"1,141"
E01005971 : Tameside 025A,"1,354",267,116,151,"1,087",95,992
E01005986 : Tameside 025B,"1,245",239,99,140,"1,006",76,930
E01005989 : Tameside 025C,"1,206",199,77,122,"1,007",91,916
E01005992 : Tameside 025D,"1,207",307,172,135,900,79,821
E01005973 : Tameside 026A,"1,367",257,98,159,"1,110",117,993
E01005976 : Tameside 026B,"1,481",322,166,156,"1,159",104,"1,055"
E01005977 : Tameside 026C,"1,448",288,138,150,"1,160",95,"1,065"
E01005978 : Tameside 026D,"1,335",296,118,178,"1,039",87,952
E01006025 : Tameside 027A,"1,916",443,235,208,"1,473",96,"1,377"
E01006027 : Tameside 027B,"2,343",496,237,259,"1,847",148,"1,699"
E01006050 : Tameside 027C,"1,841",415,196,219,"1,426",108,"1,318"
E01006052 : Tameside 027D,"1,581",406,198,208,"1,175",94,"1,081"
E01006028 : Tameside 028A,"1,776",498,250,248,"1,278",98,"1,180"
E01006029 : Tameside 028B,"1,934",340,155,185,"1,594",108,"1,486"
E01006030 : Tameside 028C,"1,870",463,209,254,"1,407",118,"1,289"
E01006039 : Tameside 028D,"1,353",268,108,160,"1,085",70,"1,015"
E01006040 : Tameside 028E,"1,891",401,224,177,"1,490",82,"1,408"
E01006041 : Tameside 028F,"1,721",313,129,184,"1,408",105,"1,303"
E01005979 : Tameside 029A,"1,586",374,194,180,"1,212",107,"1,105"
E01005980 : Tameside 029B,"1,449",344,191,153,"1,105",76,"1,029"
E01005981 : Tameside 029C,"1,647",419,225,194,"1,228",105,"1,123"
E01005982 : Tameside 029D,"1,324",316,156,160,"1,008",93,915
E01005983 : Tameside 029E,"1,507",288,129,159,"1,219",123,"1,096"
E01005984 : Tameside 029F,"1,604",382,177,205,"1,222",96,"1,126"
E01006042 : Tameside 030A,"1,696",258,89,169,"1,438",134,"1,304"
E01006043 : Tameside 030B,"1,436",277,120,157,"1,159",94,"1,065"
E01006044 : Tameside 030C,"1,523",311,144,167,"1,212",115,"1,097"
E01006045 : Tameside 030D,"1,256",191,78,113,"1,065",103,962
E01006046 : Tameside 030E,"1,528",247,98,149,"1,281",118,"1,163"
E01006109 : Trafford 001A,"1,150",261,115,146,889,59,830
E01006110 : Trafford 001B,"1,876",312,127,185,"1,564",118,"1,446"
E01006111 : Trafford 001C,"1,774",279,151,128,"1,495",71,"1,424"
E01006112 : Trafford 001D,"2,049",402,227,175,"1,647",100,"1,547"
E01006188 : Trafford 001F,"1,992",268,115,153,"1,724",132,"1,592"
E01034000 : Trafford 001G,"1,235",172,62,110,"1,063",77,986
E01034001 : Trafford 001H,"1,647",291,137,154,"1,356",71,"1,285"
E01006116 : Trafford 002A,"1,328",200,67,133,"1,128",94,"1,034"
E01006117 : Trafford 002B,"1,704",221,87,134,"1,483",128,"1,355"
E01006118 : Trafford 002C,"1,462",289,132,157,"1,173",120,"1,053"
E01006119 : Trafford 002D,"1,639",241,91,150,"1,398",117,"1,281"
E01006121 : Trafford 002E,"1,447",275,126,149,"1,172",79,"1,093"
E01006141 : Trafford 003A,"1,791",283,115,168,"1,508",123,"1,385"
E01006186 : Trafford 003B,"2,160",339,136,203,"1,821",131,"1,690"
E01006187 : Trafford 003C,"2,597",426,161,265,"2,171",179,"1,992"
E01006189 : Trafford 003D,"2,328",414,174,240,"1,914",156,"1,758"
E01006113 : Trafford 004A,"1,617",244,122,122,"1,373",79,"1,294"
E01006114 : Trafford 004B,"1,693",355,176,179,"1,338",72,"1,266"
E01006115 : Trafford 004C,"1,518",300,147,153,"1,218",85,"1,133"
E01006145 : Trafford 004D,"2,051",360,190,170,"1,691",95,"1,596"
E01006146 : Trafford 004E,"1,794",270,105,165,"1,524",121,"1,403"
E01006122 : Trafford 005A,"1,785",283,107,176,"1,502",142,"1,360"
E01006123 : Trafford 005B,"1,672",292,136,156,"1,380",134,"1,246"
E01006124 : Trafford 005C,"1,480",241,86,155,"1,239",125,"1,114"
E01006128 : Trafford 005D,"1,929",370,197,173,"1,559",139,"1,420"
E01006131 : Trafford 005E,"1,529",254,103,151,"1,275",124,"1,151"
E01006155 : Trafford 006A,"1,749",228,71,157,"1,521",139,"1,382"
E01006157 : Trafford 006B,"1,701",235,109,126,"1,466",111,"1,355"
E01006159 : Trafford 006C,"1,875",342,163,179,"1,533",117,"1,416"
E01006182 : Trafford 006D,"1,605",218,78,140,"1,387",103,"1,284"
E01006183 : Trafford 006E,"1,723",263,109,154,"1,460",114,"1,346"
E01006125 : Trafford 007A,"1,510",304,123,181,"1,206",95,"1,111"
E01006126 : Trafford 007B,"1,839",458,226,232,"1,381",99,"1,282"
E01006127 : Trafford 007C,"1,544",266,106,160,"1,278",135,"1,143"
E01006130 : Trafford 007D,"1,759",255,91,164,"1,504",169,"1,335"
E01006132 : Trafford 007E,"1,539",271,123,148,"1,268",127,"1,141"
E01006156 : Trafford 008A,"1,674",314,130,184,"1,360",106,"1,254"
E01006158 : Trafford 008B,"1,751",346,138,208,"1,405",99,"1,306"
E01006179 : Trafford 008C,"1,802",390,195,195,"1,412",126,"1,286"
E01006184 : Trafford 008D,"1,699",347,163,184,"1,352",116,"1,236"
E01006198 : Trafford 009A,"1,464",316,132,184,"1,148",87,"1,061"
E01006199 : Trafford 009B,"1,539",333,149,184,"1,206",115,"1,091"
E01006200 : Trafford 009C,"1,483",366,201,165,"1,117",117,"1,000"
E01006201 : Trafford 009D,"1,467",278,117,161,"1,189",120,"1,069"
E01006202 : Trafford 009E,"1,300",218,82,136,"1,082",128,954
E01006120 : Trafford 010A,"1,427",208,90,118,"1,219",126,"1,093"
E01006129 : Trafford 010B,"1,384",307,146,161,"1,077",121,956
E01006133 : Trafford 010C,"1,416",267,110,157,"1,149",140,"1,009"
E01006197 : Trafford 010D,"1,477",224,94,130,"1,253",130,"1,123"
E01006203 : Trafford 010E,"1,331",189,76,113,"1,142",96,"1,046"
E01006142 : Trafford 011A,"1,714",331,138,193,"1,383",129,"1,254"
E01006143 : Trafford 011B,"1,668",251,95,156,"1,417",139,"1,278"
E01006144 : Trafford 011C,"1,386",345,156,189,"1,041",93,948
E01006180 : Trafford 011D,"1,840",284,102,182,"1,556",120,"1,436"
E01006181 : Trafford 011E,"1,746",287,132,155,"1,459",112,"1,347"
E01006147 : Trafford 012A,"1,443",158,48,110,"1,285",110,"1,175"
E01006149 : Trafford 012B,"1,578",286,140,146,"1,292",119,"1,173"
E01006150 : Trafford 012C,"1,920",331,147,184,"1,589",155,"1,434"
E01006154 : Trafford 012D,"1,601",182,63,119,"1,419",140,"1,279"
E01006165 : Trafford 012E,"2,007",296,119,177,"1,711",162,"1,549"
E01006166 : Trafford 013A,"1,641",278,135,143,"1,363",121,"1,242"
E01006169 : Trafford 013B,"1,647",292,122,170,"1,355",115,"1,240"
E01006170 : Trafford 013C,"1,602",222,96,126,"1,380",127,"1,253"
E01006171 : Trafford 013D,"1,755",366,176,190,"1,389",103,"1,286"
E01006098 : Trafford 014A,"1,334",181,77,104,"1,153",113,"1,040"
E01006099 : Trafford 014B,"1,322",174,63,111,"1,148",111,"1,037"
E01006164 : Trafford 014C,"1,763",266,102,164,"1,497",142,"1,355"
E01006174 : Trafford 014D,"1,788",258,92,166,"1,530",151,"1,379"
E01006178 : Trafford 014E,"1,813",240,100,140,"1,573",167,"1,406"
E01006097 : Trafford 015A,"1,783",261,121,140,"1,522",138,"1,384"
E01006160 : Trafford 015B,"2,140",389,141,248,"1,751",151,"1,600"
E01006161 : Trafford 015C,"2,158",278,100,178,"1,880",180,"1,700"
E01006162 : Trafford 015D,"1,622",181,55,126,"1,441",157,"1,284"
E01006163 : Trafford 015E,"1,832",209,55,154,"1,623",149,"1,474"
E01006148 : Trafford 016A,"1,699",313,140,173,"1,386",143,"1,243"
E01006151 : Trafford 016B,"1,581",206,60,146,"1,375",121,"1,254"
E01006152 : Trafford 016C,"1,639",248,81,167,"1,391",150,"1,241"
E01006153 : Trafford 016D,"1,600",237,90,147,"1,363",129,"1,234"
E01006172 : Trafford 016E,"1,539",268,122,146,"1,271",131,"1,140"
E01006104 : Trafford 017A,"1,687",369,171,198,"1,318",111,"1,207"
E01006105 : Trafford 017B,"1,766",436,214,222,"1,330",88,"1,242"
E01006106 : Trafford 017C,"1,474",412,199,213,"1,062",85,977
E01006107 : Trafford 017D,"1,591",365,182,183,"1,226",88,"1,138"
E01006108 : Trafford 017E,"1,668",417,206,211,"1,251",75,"1,176"
E01006102 : Trafford 018A,"1,403",224,91,133,"1,179",105,"1,074"
E01006173 : Trafford 018B,"1,548",188,75,113,"1,360",134,"1,226"
E01006175 : Trafford 018C,"1,777",447,228,219,"1,330",113,"1,217"
E01006176 : Trafford 018D,"1,733",263,125,138,"1,470",129,"1,341"
E01006177 : Trafford 018E,"1,653",334,154,180,"1,319",99,"1,220"
E01006091 : Trafford 019A,"2,970",325,110,215,"2,645",229,"2,416"
E01006092 : Trafford 019B,"1,332",227,121,106,"1,105",85,"1,020"
E01006095 : Trafford 019C,"1,658",211,72,139,"1,447",144,"1,303"
E01006167 : Trafford 019D,"1,579",384,197,187,"1,195",114,"1,081"
E01006168 : Trafford 019E,"1,813",447,225,222,"1,366",108,"1,258"
E01006090 : Trafford 020A,"2,298",342,178,164,"1,956",177,"1,779"
E01006094 : Trafford 020B,"1,603",195,63,132,"1,408",138,"1,270"
E01006096 : Trafford 020C,"1,608",177,58,119,"1,431",119,"1,312"
E01006100 : Trafford 020D,"1,488",197,88,109,"1,291",110,"1,181"
E01006103 : Trafford 020E,"1,693",170,54,116,"1,523",128,"1,395"
E01006101 : Trafford 021A,"1,495",179,53,126,"1,316",122,"1,194"
E01006190 : Trafford 021B,"1,687",243,100,143,"1,444",118,"1,326"
E01006195 : Trafford 021C,"1,795",218,73,145,"1,577",143,"1,434"
E01006196 : Trafford 021D,"1,700",207,76,131,"1,493",116,"1,377"
E01006210 : Trafford 021E,"1,608",224,85,139,"1,384",131,"1,253"
E01006204 : Trafford 022A,"1,620",292,118,174,"1,328",122,"1,206"
E01006206 : Trafford 022B,"1,869",343,164,179,"1,526",123,"1,403"
E01006207 : Trafford 022C,"1,747",456,257,199,"1,291",99,"1,192"
E01006208 : Trafford 022D,"1,549",243,97,146,"1,306",86,"1,220"
E01006211 : Trafford 022E,"1,613",320,136,184,"1,293",119,"1,174"
E01006093 : Trafford 023A,"1,527",194,69,125,"1,333",141,"1,192"
E01006191 : Trafford 023B,"1,708",202,71,131,"1,506",143,"1,363"
E01006192 : Trafford 023C,"1,517",225,99,126,"1,292",139,"1,153"
E01006205 : Trafford 023D,"1,342",182,65,117,"1,160",93,"1,067"
E01006209 : Trafford 023E,"1,643",220,86,134,"1,423",127,"1,296"
E01006078 : Trafford 024A,"2,123",233,83,150,"1,890",164,"1,726"
E01006080 : Trafford 024B,"1,968",279,128,151,"1,689",111,"1,578"
E01006089 : Trafford 024C,"2,013",226,83,143,"1,787",135,"1,652"
E01006193 : Trafford 024D,"1,571",207,89,118,"1,364",126,"1,238"
E01006194 : Trafford 024E,"2,429",249,94,155,"2,180",176,"2,004"
E01006074 : Trafford 025A,"1,641",320,177,143,"1,321",105,"1,216"
E01006075 : Trafford 025B,"2,146",257,89,168,"1,889",165,"1,724"
E01006076 : Trafford 025C,"1,675",279,107,172,"1,396",137,"1,259"
E01006079 : Trafford 025D,"2,595",250,85,165,"2,345",209,"2,136"
E01006087 : Trafford 025E,"1,451",178,51,127,"1,273",98,"1,175"
E01006083 : Trafford 026A,"1,279",141,43,98,"1,138",95,"1,043"
E01006084 : Trafford 026B,"1,743",165,48,117,"1,578",149,"1,429"
E01006088 : Trafford 026C,"1,630",148,60,88,"1,482",118,"1,364"
E01006139 : Trafford 026D,"1,805",188,47,141,"1,617",147,"1,470"
E01006140 : Trafford 026E,"1,697",183,61,122,"1,514",147,"1,367"
E01006077 : Trafford 027A,"1,643",250,93,157,"1,393",130,"1,263"
E01006081 : Trafford 027B,"1,385",178,68,110,"1,207",104,"1,103"
E01006082 : Trafford 027C,"1,496",200,69,131,"1,296",121,"1,175"
E01006085 : Trafford 027D,"1,542",179,90,89,"1,363",128,"1,235"
E01006086 : Trafford 027E,"1,688",260,107,153,"1,428",110,"1,318"
E01006134 : Trafford 028A,"1,493",128,34,94,"1,365",97,"1,268"
E01006135 : Trafford 028B,"1,767",267,108,159,"1,500",108,"1,392"
E01006136 : Trafford 028C,"1,702",196,61,135,"1,506",104,"1,402"
E01006137 : Trafford 028D,"1,421",163,51,112,"1,258",99,"1,159"
E01006138 : Trafford 028E,"1,893",333,149,184,"1,560",115,"1,445"
E01006315 : Wigan 001A,"1,503",208,76,132,"1,295",144,"1,151"
E01006316 : Wigan 001B,"2,003",269,106,163,"1,734",170,"1,564"
E01006317 : Wigan 001C,"1,552",315,136,179,"1,237",117,"1,120"
E01006319 : Wigan 001D,"1,573",169,62,107,"1,404",103,"1,301"
E01006229 : Wigan 002A,"1,377",263,106,157,"1,114",114,"1,000"
E01006230 : Wigan 002B,"2,122",284,99,185,"1,838",159,"1,679"
E01006233 : Wigan 002C,"1,404",226,87,139,"1,178",136,"1,042"
E01006237 : Wigan 002D,"1,922",259,97,162,"1,663",146,"1,517"
E01006238 : Wigan 002E,"1,509",348,187,161,"1,161",101,"1,060"
E01006259 : Wigan 003A,"1,316",240,107,133,"1,076",90,986
E01006312 : Wigan 003B,"1,370",251,111,140,"1,119",114,"1,005"
E01006313 : Wigan 003C,"1,458",286,133,153,"1,172",74,"1,098"
E01006314 : Wigan 003D,"1,725",336,127,209,"1,389",146,"1,243"
E01006318 : Wigan 003E,"1,426",285,107,178,"1,141",118,"1,023"
E01006320 : Wigan 003F,"1,279",244,92,152,"1,035",95,940
E01006321 : Wigan 003G,"1,601",265,104,161,"1,336",129,"1,207"
E01006231 : Wigan 004A,"1,466",259,110,149,"1,207",101,"1,106"
E01006232 : Wigan 004B,"1,989",292,126,166,"1,697",137,"1,560"
E01006234 : Wigan 004C,"1,142",240,111,129,902,97,805
E01006235 : Wigan 004D,"1,528",407,209,198,"1,121",108,"1,013"
E01006253 : Wigan 005A,"1,524",349,156,193,"1,175",117,"1,058"
E01006254 : Wigan 005B,"1,572",385,188,197,"1,187",69,"1,118"
E01006255 : Wigan 005C,"1,492",295,125,170,"1,197",123,"1,074"
E01006256 : Wigan 005D,"1,707",303,139,164,"1,404",118,"1,286"
E01006260 : Wigan 005E,"1,515",362,191,171,"1,153",88,"1,065"
E01006370 : Wigan 006A,"1,886",334,140,194,"1,552",127,"1,425"
E01006372 : Wigan 006B,"1,609",220,100,120,"1,389",119,"1,270"
E01006373 : Wigan 006C,"1,459",211,90,121,"1,248",137,"1,111"
E01006374 : Wigan 006D,"1,463",209,90,119,"1,254",111,"1,143"
E01006390 : Wigan 006E,"1,612",350,157,193,"1,262",110,"1,152"
E01006236 : Wigan 007A,"1,573",245,104,141,"1,328",105,"1,223"
E01006388 : Wigan 007B,"1,837",396,196,200,"1,441",111,"1,330"
E01006389 : Wigan 007C,"1,318",193,89,104,"1,125",78,"1,047"
E01006391 : Wigan 007D,"1,530",335,159,176,"1,195",103,"1,092"
E01006257 : Wigan 008A,"1,207",221,108,113,986,82,904
E01006258 : Wigan 008B,"1,599",333,165,168,"1,266",144,"1,122"
E01006369 : Wigan 008C,"2,029",433,194,239,"1,596",125,"1,471"
E01006371 : Wigan 008D,"1,476",276,122,154,"1,200",111,"1,089"
E01006375 : Wigan 008E,"1,683",271,118,153,"1,412",135,"1,277"
E01006306 : Wigan 009A,"1,479",420,221,199,"1,059",78,981
E01006307 : Wigan 009B,"1,374",311,171,140,"1,063",102,961
E01006386 : Wigan 009C,"1,587",588,332,256,999,85,914
E01006387 : Wigan 009D,"1,315",307,147,160,"1,008",82,926
E01006392 : Wigan 009E,"1,477",320,170,150,"1,157",67,"1,090"
E01006350 : Wigan 010A,"1,858",478,269,209,"1,380",104,"1,276"
E01006351 : Wigan 010B,"2,020",533,259,274,"1,487",86,"1,401"
E01006357 : Wigan 010C,"1,830",511,265,246,"1,319",84,"1,235"
E01006360 : Wigan 010D,"1,680",388,209,179,"1,292",81,"1,211"
E01006361 : Wigan 010E,"1,661",396,201,195,"1,265",97,"1,168"
E01006356 : Wigan 011A,"1,434",342,165,177,"1,092",81,"1,011"
E01006396 : Wigan 011B,"1,480",302,167,135,"1,178",99,"1,079"
E01006397 : Wigan 011C,"1,080",290,167,123,790,56,734
E01006398 : Wigan 011D,"1,008",253,130,123,755,69,686
E01006399 : Wigan 011E,"1,603",315,141,174,"1,288",107,"1,181"
E01006305 : Wigan 012A,"1,710",379,180,199,"1,331",72,"1,259"
E01006308 : Wigan 012B,"1,620",353,158,195,"1,267",75,"1,192"
E01006309 : Wigan 012C,"1,670",345,183,162,"1,325",92,"1,233"
E01006310 : Wigan 012D,"1,587",360,197,163,"1,227",87,"1,140"
E01006311 : Wigan 012E,"1,534",334,166,168,"1,200",95,"1,105"
E01006269 : Wigan 013A,"1,737",392,212,180,"1,345",123,"1,222"
E01006271 : Wigan 013B,"1,682",330,159,171,"1,352",136,"1,216"
E01006272 : Wigan 013C,"1,634",337,162,175,"1,297",123,"1,174"
E01006273 : Wigan 013D,"1,482",359,177,182,"1,123",101,"1,022"
E01006276 : Wigan 013E,"2,154",352,162,190,"1,802",150,"1,652"
E01006353 : Wigan 014A,"1,458",276,133,143,"1,182",115,"1,067"
E01006354 : Wigan 014B,"1,440",386,202,184,"1,054",91,963
E01006355 : Wigan 014C,"1,474",262,113,149,"1,212",115,"1,097"
E01006358 : Wigan 014D,"2,133",496,247,249,"1,637",121,"1,516"
E01006359 : Wigan 014E,"1,384",309,142,167,"1,075",83,992
E01006349 : Wigan 015A,"2,038",350,153,197,"1,688",138,"1,550"
E01006352 : Wigan 015B,"2,036",436,201,235,"1,600",137,"1,463"
E01006404 : Wigan 015C,"1,779",355,166,189,"1,424",125,"1,299"
E01006405 : Wigan 015D,"1,745",408,193,215,"1,337",119,"1,218"
E01006411 : Wigan 015E,"1,434",404,210,194,"1,030",79,951
E01006270 : Wigan 016A,"1,446",433,228,205,"1,013",100,913
E01006274 : Wigan 016B,"1,531",349,161,188,"1,182",105,"1,077"
E01006275 : Wigan 016C,"1,571",428,231,197,"1,143",97,"1,046"
E01006277 : Wigan 016D,"1,877",224,87,137,"1,653",149,"1,504"
E01006286 : Wigan 016E,"1,561",369,177,192,"1,192",119,"1,073"
E01006239 : Wigan 017A,"2,085",602,323,279,"1,483",94,"1,389"
E01006240 : Wigan 017B,"1,576",399,204,195,"1,177",80,"1,097"
E01006241 : Wigan 017C,"2,538",469,203,266,"2,069",152,"1,917"
E01006287 : Wigan 017D,"1,145",179,68,111,966,97,869
E01006289 : Wigan 017E,"1,689",455,249,206,"1,234",112,"1,122"
E01006362 : Wigan 018A,"1,634",270,97,173,"1,364",127,"1,237"
E01006363 : Wigan 018B,"1,516",300,130,170,"1,216",130,"1,086"
E01006364 : Wigan 018C,"1,831",358,163,195,"1,473",124,"1,349"
E01006365 : Wigan 018D,"2,266",307,96,211,"1,959",147,"1,812"
E01006366 : Wigan 018E,"1,850",391,194,197,"1,459",153,"1,306"
E01006367 : Wigan 018F,"1,783",281,106,175,"1,502",132,"1,370"
E01006368 : Wigan 018G,"1,884",306,123,183,"1,578",164,"1,414"
E01006278 : Wigan 019A,"1,634",390,173,217,"1,244",115,"1,129"
E01006279 : Wigan 019B,"1,577",246,99,147,"1,331",107,"1,224"
E01006280 : Wigan 019C,"1,454",409,195,214,"1,045",85,960
E01006281 : Wigan 019D,"1,937",326,118,208,"1,611",145,"1,466"
E01006285 : Wigan 019E,"1,917",354,158,196,"1,563",135,"1,428"
E01006406 : Wigan 020A,"1,377",299,139,160,"1,078",83,995
E01006407 : Wigan 020B,"1,453",243,118,125,"1,210",117,"1,093"
E01006408 : Wigan 020C,"1,746",357,190,167,"1,389",103,"1,286"
E01006409 : Wigan 020D,"1,298",283,119,164,"1,015",95,920
E01006410 : Wigan 020E,"1,270",253,99,154,"1,017",80,937
E01006393 : Wigan 021A,"1,381",210,93,117,"1,171",111,"1,060"
E01006394 : Wigan 021B,"1,540",266,121,145,"1,274",102,"1,172"
E01006395 : Wigan 021C,"2,629",292,104,188,"2,337",207,"2,130"
E01006400 : Wigan 021D,"1,995",235,107,128,"1,760",125,"1,635"
E01006401 : Wigan 021E,"1,354",230,96,134,"1,124",95,"1,029"
E01006402 : Wigan 021F,"1,129",200,86,114,929,80,849
E01006403 : Wigan 021G,"1,626",276,119,157,"1,350",136,"1,214"
E01006290 : Wigan 022A,"1,389",266,108,158,"1,123",106,"1,017"
E01006291 : Wigan 022B,"1,461",300,127,173,"1,161",126,"1,035"
E01006292 : Wigan 022C,"1,500",320,155,165,"1,180",117,"1,063"
E01006293 : Wigan 022D,"1,618",373,191,182,"1,245",126,"1,119"
E01006242 : Wigan 023A,"1,928",391,165,226,"1,537",147,"1,390"
E01006243 : Wigan 023B,"2,120",322,138,184,"1,798",139,"1,659"
E01006244 : Wigan 023C,"1,676",475,254,221,"1,201",114,"1,087"
E01006245 : Wigan 023D,"2,628",375,155,220,"2,253",187,"2,066"
E01006213 : Wigan 024A,"1,522",375,183,192,"1,147",81,"1,066"
E01006215 : Wigan 024B,"1,713",498,274,224,"1,215",98,"1,117"
E01006217 : Wigan 024C,"2,377",466,241,225,"1,911",147,"1,764"
E01006218 : Wigan 024D,"2,432",451,202,249,"1,981",153,"1,828"
E01006219 : Wigan 024E,"1,184",265,118,147,919,77,842
E01006288 : Wigan 025A,"1,824",435,229,206,"1,389",102,"1,287"
E01006294 : Wigan 025B,"1,940",321,135,186,"1,619",163,"1,456"
E01006295 : Wigan 025C,"1,566",369,177,192,"1,197",112,"1,085"
E01006377 : Wigan 025D,"1,557",269,117,152,"1,288",130,"1,158"
E01006378 : Wigan 025E,"1,303",244,113,131,"1,059",103,956
E01006212 : Wigan 026A,"1,392",257,128,129,"1,135",122,"1,013"
E01006214 : Wigan 026B,"1,379",289,142,147,"1,090",94,996
E01006216 : Wigan 026C,"2,190",375,145,230,"1,815",154,"1,661"
E01006322 : Wigan 026D,"2,089",422,191,231,"1,667",152,"1,515"
E01006329 : Wigan 026E,"1,637",472,206,266,"1,165",106,"1,059"
E01006282 : Wigan 027A,"1,854",396,200,196,"1,458",123,"1,335"
E01006283 : Wigan 027B,"1,584",368,180,188,"1,216",92,"1,124"
E01006284 : Wigan 027C,"1,577",422,220,202,"1,155",86,"1,069"
E01006336 : Wigan 027D,"1,656",496,262,234,"1,160",94,"1,066"
E01006337 : Wigan 027E,"1,496",277,128,149,"1,219",92,"1,127"
E01006376 : Wigan 028A,"1,770",373,179,194,"1,397",131,"1,266"
E01006381 : Wigan 028B,"2,051",214,82,132,"1,837",160,"1,677"
E01006382 : Wigan 028C,"1,258",182,69,113,"1,076",113,963
E01006383 : Wigan 028D,"1,609",241,113,128,"1,368",116,"1,252"
E01006384 : Wigan 028E,"1,320",189,61,128,"1,131",114,"1,017"
E01006250 : Wigan 029A,"2,139",285,105,180,"1,854",160,"1,694"
E01006251 : Wigan 029B,"1,546",241,81,160,"1,305",121,"1,184"
E01006379 : Wigan 029C,"1,581",270,101,169,"1,311",129,"1,182"
E01006380 : Wigan 029D,"2,731",463,215,248,"2,268",158,"2,110"
E01006385 : Wigan 029E,"1,445",245,118,127,"1,200",99,"1,101"
E01006328 : Wigan 030A,"1,526",297,134,163,"1,229",75,"1,154"
E01006333 : Wigan 030B,"2,088",396,154,242,"1,692",152,"1,540"
E01006334 : Wigan 030C,"2,078",394,166,228,"1,684",119,"1,565"
E01006338 : Wigan 030D,"1,668",315,135,180,"1,353",120,"1,233"
E01006248 : Wigan 031A,"2,280",502,256,246,"1,778",134,"1,644"
E01006249 : Wigan 031B,"1,656",371,181,190,"1,285",95,"1,190"
E01006330 : Wigan 031C,"1,538",288,109,179,"1,250",112,"1,138"
E01006331 : Wigan 031D,"1,516",206,90,116,"1,310",109,"1,201"
E01006332 : Wigan 031E,"2,016",489,275,214,"1,527",143,"1,384"
E01006262 : Wigan 032A,"1,712",360,162,198,"1,352",109,"1,243"
E01006263 : Wigan 032B,"1,490",273,135,138,"1,217",109,"1,108"
E01006266 : Wigan 032C,"1,373",292,122,170,"1,081",125,956
E01006267 : Wigan 032D,"1,620",446,228,218,"1,174",94,"1,080"
E01006268 : Wigan 032E,"1,637",292,136,156,"1,345",134,"1,211"
E01006323 : Wigan 033A,"1,552",364,191,173,"1,188",82,"1,106"
E01006324 : Wigan 033B,"1,291",345,177,168,946,86,860
E01006325 : Wigan 033C,"1,505",319,160,159,"1,186",109,"1,077"
E01006326 : Wigan 033D,"1,411",291,120,171,"1,120",84,"1,036"
E01006327 : Wigan 033E,"2,560",561,293,268,"1,999",152,"1,847"
E01006246 : Wigan 034A,"1,535",351,155,196,"1,184",92,"1,092"
E01006247 : Wigan 034B,"1,279",217,75,142,"1,062",95,967
E01006252 : Wigan 034C,"1,398",239,88,151,"1,159",100,"1,059"
E01006297 : Wigan 034D,"1,595",449,235,214,"1,146",85,"1,061"
E01006335 : Wigan 034E,"1,578",340,146,194,"1,238",120,"1,118"
E01006220 : Wigan 035A,"1,741",428,242,186,"1,313",118,"1,195"
E01006221 : Wigan 035B,"1,558",309,124,185,"1,249",116,"1,133"
E01006222 : Wigan 035C,"1,556",272,114,158,"1,284",118,"1,166"
E01006224 : Wigan 035D,"1,431",173,70,103,"1,258",89,"1,169"
E01006226 : Wigan 035E,"1,714",301,141,160,"1,413",140,"1,273"
E01006223 : Wigan 036A,"1,586",330,163,167,"1,256",111,"1,145"
E01006225 : Wigan 036B,"1,507",259,121,138,"1,248",94,"1,154"
E01006261 : Wigan 036C,"1,487",399,215,184,"1,088",100,988
E01006264 : Wigan 036D,"1,230",208,97,111,"1,022",105,917
E01006265 : Wigan 036E,"1,396",290,124,166,"1,106",100,"1,006"
E01006296 : Wigan 037A,"1,503",405,205,200,"1,098",85,"1,013"
E01006298 : Wigan 037B,"1,423",362,169,193,"1,061",80,981
E01006299 : Wigan 037C,"1,936",291,112,179,"1,645",143,"1,502"
E01006300 : Wigan 037D,"1,360",233,94,139,"1,127",112,"1,015"
E01006301 : Wigan 037E,"1,485",232,93,139,"1,253",128,"1,125"
E01006227 : Wigan 038A,"1,579",285,124,161,"1,294",110,"1,184"
E01006228 : Wigan 038B,"1,628",305,117,188,"1,323",104,"1,219"
E01006342 : Wigan 038C,"1,557",361,188,173,"1,196",104,"1,092"
E01006344 : Wigan 038D,"1,441",418,206,212,"1,023",79,944
E01006346 : Wigan 038E,"2,062",377,157,220,"1,685",138,"1,547"
E01006339 : Wigan 039A,"1,254",244,104,140,"1,010",108,902
E01006340 : Wigan 039B,"1,888",382,193,189,"1,506",112,"1,394"
E01006343 : Wigan 039C,"1,612",208,73,135,"1,404",141,"1,263"
E01006345 : Wigan 039D,"1,559",319,121,198,"1,240",144,"1,096"
E01006348 : Wigan 039E,"2,641",392,171,221,"2,249",194,"2,055"
E01006302 : Wigan 040A,"1,834",282,118,164,"1,552",123,"1,429"
E01006303 : Wigan 040B,"1,624",286,109,177,"1,338",124,"1,214"
E01006304 : Wigan 040C,"1,520",308,151,157,"1,212",107,"1,105"
E01006341 : Wigan 040D,"1,662",411,181,230,"1,251",128,"1,123"
E01006347 : Wigan 040E,"1,518",277,95,182,"1,241",121,"1,120"
